$abah	SF
>a$obAh	BP
$abaH	SF
>a$obAH	BP
*abiyHap	SF
*abA}iH	BP
>abotar	SF
butor	BP
$Adir	SF
$awAdir	BP
>adoEaY	SF
>adoEaY	BP
$Aduwf	SF
$awAdiyf	BP
$aEiyrap	SF
$aEA}ir	BP
$aEob	SF
$uEuwb	BP
$aEofap	SF
$iEAf	BP
>aEotaY	SF
>aEotaY	BP
$AfiE	SF
$awAfiE	BP
$afiyE	SF
$ufaEA'	BP
$afoE	SF
>a$ofAE	BP
$afoE	SF
$ifAE	BP
>afoEaY	SF
>afAEiy	BP
>afoEaY	SF
>afAEiy	BP
$afor	SF
>a$ofAr	BP
>agolaY	SF
>agolaY	BP
$ahiyd	SF
$uhadA'	BP
$Ahiyn	SF
$awAhiyn	BP
>ahodaY	SF
>ahodaY	BP
$ahor	SF
>a$ohur	BP
$ahor	SF
$uhuwr	BP
>ahowaY	SF
>ahowaY	BP
>ajal	SF
|jAl	BP
$ajan	SF
>a$ojAn	BP
$ajan	SF
$ujuwn	BP
>ajor	SF
>ujuwr	BP
$ak~	SF
$ukuwk	BP
$ak~	SF
$ukuwk	BP
*akar	SF
*ukorAn	BP
*akar	SF
*ukuwr	BP
$Akilap	SF
$awAkil	BP
$akiym	SF
$akA}im	BP
$akiym	SF
$ukum	BP
$akol	SF
>a$okAl	BP
$akowaY	SF
$akAwaY	BP
$Akuw$	SF
$awAkiy$	BP
$alotap	SF
$ilat	BP
>alovag	SF
luvog	BP
>amal	SF
|mAl	BP
>amor	SF
>umuwr	BP
$amos	SF
$umuws	BP
>anobAr	SF
>anAbiyr	BP
>anof	SF
>unuwf	BP
$anof	SF
$unuwf	BP
$anokal	SF
$anAkil	BP
>anokaY	SF
>anokaY	BP
$anoTap	SF
$unaT	BP
>a*okaY	SF
>a*okaY	BP
$aq~	SF
$uquwq	BP
$aq~	SF
$uquwq	BP
$aq~ap	SF
$uqaq	BP
$aqiyq	SF
>a$iq~A'	BP
$aqiyq	SF
>a$iq~ap	BP
*aqon	SF
>a*oqAn	BP
*aqon	SF
*uquwn	BP
>aqowaY	SF
>aqowaY	BP
$araj	SF
>a$orAj	BP
$arak	SF
>a$orAk	BP
$araT	SF
>a$orAT	BP
$Aridap	SF
$awArid	BP
$AriE	SF
$awAriE	BP
$Ariy	SF
$urAap	BP
$ariyHap	SF
$arA}iH	BP
$ariyk	SF
$urakA'	BP
$ariyk	SF
$arA}ik	BP
>ariykap	SF
>arA}ik	BP
$ariyT	SF
>a$oriTap	BP
$ariyT	SF
$arA}iT	BP
>aro$	SF
>uruw$	BP
$aro$af	SF
$arA$if	BP
>arodab~	SF
>arAdib	BP
$aroH	SF
$uruwH	BP
>arojuwHap	SF
>arAjiyH	BP
$arom	SF
$uruwm	BP
>aromal	SF
>arAmil	BP
>aromal	SF
>arAmil	BP
>aromalap	SF
>arAmil	BP
>aronab	SF
>arAnib	BP
>aronab	SF
>arAnib	BP
$aroT	SF
$uruwT	BP
$arox	SF
$uruwx	BP
>asad	SF
|sAd	BP
>asad	SF
>usuwd	BP
>aSiyS	SF
>aSA}iS	BP
>aSiyS	SF
>uSuS	BP
>asonaY	SF
>asonaY	BP
>asotik	SF
>asAtik	BP
$aT~	SF
$uTuwT	BP
$aT~	SF
$uTuwT	BP
$ATi}	SF
$awATi}	BP
$atiyl	SF
$atA}il	BP
$atiymap	SF
$atA}im	BP
$aTiyrap	SF
$aTA}ir	BP
>aTolas	SF
>aTAlis	BP
>aTolas	SF
>aTAlis	BP
$aTon	SF
>a$oTAn	BP
>at~uwn	SF
>atAtiyn	BP
>awAn	SF
|winap	BP
$awobak	SF
$awAbik	BP
$awobak	SF
$awAbik	BP
$awobak	SF
$awAbik	BP
>awodap	SF
<iwAd	BP
>awofaY	SF
>awofaY	BP
$awok	SF
>a$owAk	BP
$awoq	SF
>a$owAq	BP
>axiy*	SF
>axo*aY	BP
>axomaS	SF
>axAmiS	BP
>axomaS	SF
>axAmiS	BP
$axoS	SF
>a$oxAS	BP
$axoS	SF
$uxuwS	BP
$axotuwr	SF
$axAtiyr	BP
$ayoTAn	SF
$ayATiyn	BP
$ayox	SF
>a$oyAx	BP
$ayox	SF
$uyuwx	BP
$aZaf	SF
$iZAf	BP
>azoEar	SF
zuEorAn	BP
bAb	SF
>abowAb	BP
bAb	SF
biybAn	BP
babor	SF
bubuwr	BP
bAbuwj	SF
bawAbiyj	BP
bAbuwr	SF
bawAbiyr	BP
bAdirap	SF
bawAdir	BP
badiyEap	SF
badA}iE	BP
bAE	SF
>abowAE	BP
baEiyr	SF
buEorAn	BP
baEol	SF
biEAl	BP
baEol	SF
buEuwl	BP
baEov	SF
buEuwv	BP
bagiy~	SF
bagAyA	BP
bagol	SF
>abogAl	BP
bagol	SF
bigAl	BP
baHor	SF
>aboHAr	BP
baHor	SF
>aboHur	BP
baHor	SF
biHAr	BP
baHor	SF
buHuwr	BP
bahow	SF
>abohA'	BP
bahow	SF
>abohA}	BP
bahow	SF
>abohA&	BP
bA}iqap	SF
bawA}iq	BP
bA}iqap	SF
bawA}iq	BP
ba$iyr	SF
bu$arA'	BP
bAkirap	SF
bawAkir	BP
bAkiy	SF
bukAap	BP
bakor	SF
>abokur	BP
bakor	SF
bukorAn	BP
bakoraj	SF
bakArij	BP
balad	SF
bulodAn	BP
bal~AS	SF
balAliyS	BP
baliy~ap	SF
balAyA	BP
baloEam	SF
balAEim	BP
baloqaE	SF
balAqiE	BP
banod	SF
bunuwd	BP
banodar	SF
banAdir	BP
banok	SF
bunuwk	BP
ba$okiyr	SF
ba$Akiyr	BP
baqiy~ap	SF
baqAyA	BP
baqo$iy$	SF
baqA$iy$	BP
baqol	SF
buquwl	BP
bArijap	SF
bawArij	BP
bariyzap	SF
barA}iz	BP
baro*aEap	SF
barA*iE	BP
barobax	SF
barAbix	BP
barodaEap	SF
barAdiE	BP
baroguwv	SF
barAgiyv	BP
baromaq	SF
barAmiq	BP
baromiyl	SF
barAmiyl	BP
baroniy~ap	SF
barAniy	BP
barowAz	SF
barAwiyz	BP
barozax	SF
barAzix	BP
bAruwdap	SF
bawAriyd	BP
bas~ap	SF
bisAs	BP
bASirap	SF
bawASir	BP
baSiyrap	SF
baSA}ir	BP
baT~	SF
buTuwT	BP
baT~	SF
buTuwT	BP
baTal	SF
>aboTAl	BP
bATiyap	SF
bawATiy	BP
baxo$iy$	SF
baxA$iy$	BP
bayodaq	SF
bayAdiq	BP
bayodaq	SF
bayAdiq	BP
bayodar	SF
bayAdir	BP
bayodar	SF
bayAdir	BP
bayoraq	SF
bayAriq	BP
bayoraq	SF
bayAriq	BP
bAz	SF
biyzAn	BP
bAziy	SF
bawAziy	BP
bAziy	SF
buzAap	BP
bazobuwz	SF
bazAbiyz	BP
baZor	SF
buZuwr	BP
bidoEap	SF
bidaE	BP
binoSir	SF
banASir	BP
bi}or	SF
bi}Ar	BP
birobap	SF
barAbiy	BP
birokap	SF
birak	BP
biroTiyl	SF
barATiyl	BP
biToriyq	SF
baTAriqap	BP
biToriyq	SF
baTAriyq	BP
bizor	SF
buzuwr	BP
buEobuE	SF
baEAbiE	BP
buEod	SF
>aboEAd	BP
buholuwl	SF
bahAliyl	BP
bulobul	SF
balAbil	BP
buloEuwm	SF
balAEiym	BP
bunoduq	SF
banAdiq	BP
bunoduwq	SF
banAdiyq	BP
bunoT	SF
bunuwT	BP
bunoTap	SF
bunaT	BP
bu&orap	SF
bu&ar	BP
buqojap	SF
buqaj	BP
buro$	SF
>aborA$	BP
burod	SF
>aborAd	BP
buroEum	SF
barAEim	BP
buroEuwm	SF
barAEiym	BP
burogiy	SF
barAgiy	BP
buroj	SF
>aborAj	BP
buroj	SF
buruwj	BP
burojumap	SF
barAjim	BP
burokAn	SF
barAkiyn	BP
buromap	SF
buram	BP
buronus	SF
barAnis	BP
buronus	SF
barAniys	BP
buroquE	SF
barAqiE	BP
burovun	SF
barAvin	BP
busotAn	SF
basAtiyn	BP
buwliysap	SF
bawAlis	BP
buwliySap	SF
bawAliS	BP
buwz	SF
>abowAz	BP
buxonuq	SF
baxAniq	BP
buz~	SF
>abozAz	BP
dA'	SF
>adowA'	BP
dA'	SF
>adowA}	BP
dA'	SF
>adowA&	BP
dAb~ap	SF
dawAb~	BP
DAbiT	SF
Dub~AT	BP
daboduwbap	SF
dabAdiyb	BP
DaboE	SF
>aDobuE	BP
DaboE	SF
DibAE	BP
dab~uwr	SF
dabAbiyr	BP
dab~uws	SF
dabAbiys	BP
daEiy~	SF
>adoEiyA'	BP
daEiy~	SF
>adoEiyA'	BP
dAEiy	SF
duEAap	BP
daEowaY	SF
daEAwaY	BP
daf~	SF
dufuwf	BP
daf~	SF
dufuwf	BP
dAfiE	SF
dawAfiE	BP
dafiynap	SF
dafA}in	BP
DafodaE	SF
DafAdiE	BP
dafotar	SF
dafAtir	BP
DAHiyap	SF
DawAHiy	BP
DaHiy~ap	SF
DaHAyA	BP
dahor	SF
>adohur	BP
dahor	SF
duhuwr	BP
Dahor	SF
Duhuwr	BP
DA}iqap	SF
DawA}iq	BP
DA}iqap	SF
DawA}iq	BP
dA}irap	SF
dawA}ir	BP
dA}irap	SF
dawA}ir	BP
dal~ap	SF
dilAl	BP
dAliyap	SF
dawAliy	BP
daliyl	SF
dalA}il	BP
Damiymap	SF
DamA}im	BP
Damiyr	SF
DamA}ir	BP
dAniq	SF
dawAniq	BP
daqal	SF
>adoqAl	BP
dAqirap	SF
dawAqir	BP
daqiyqap	SF
daqA}iq	BP
daqol	SF
diqAl	BP
daraj	SF
>adorAj	BP
Dar~ap	SF
DarA}ir	BP
Darar	SF
>aDorAr	BP
dAriEap	SF
dawAriE	BP
darob	SF
duruwb	BP
DaroE	SF
DirAE	BP
DaroE	SF
DuruwE	BP
darofiyl	SF
darAfiyl	BP
Darogam	SF
DarAgim	BP
darowiy$	SF
darAwiy$	BP
dasiysap	SF
dasA}is	BP
dasokarap	SF
dasAkir	BP
dawA'	SF
>adowiyap	BP
Dawo'	SF
>aDowA'	BP
Dawo'	SF
>aDowA}	BP
Dawo'	SF
>aDowA&	BP
dawolap	SF
duwal	BP
dawor	SF
>adowAr	BP
daworaq	SF
dawAriq	BP
daworaq	SF
dawAriq	BP
daworaq	SF
dawAriq	BP
dAxilap	SF
dawAxil	BP
daxiylap	SF
daxA}il	BP
DayoEap	SF
DiyAE	BP
Dayof	SF
Duyuwf	BP
dayon	SF
duyuwn	BP
dayor	SF
>adoyAr	BP
dibolap	SF
dibal	BP
DiEof	SF
>aDoEAf	BP
Digov	SF
>aDogAv	BP
diholiyz	SF
dahAliyz	BP
dihoqAn	SF
dahAqinap	BP
dihoqAn	SF
dahAqiyn	BP
dik~ap	SF
dikak	BP
DiloE	SF
>aDolAE	BP
DiloE	SF
DuluwE	BP
DimAdap	SF
DamA}id	BP
dimAg	SF
>adomigap	BP
dinokil	SF
danAkil	BP
dir~ap	SF
dirar	BP
diroham	SF
darAhim	BP
Diros	SF
>aDorAs	BP
Diros	SF
Duruws	BP
Dirow	SF
DirA'	BP
divAr	SF
duvur	BP
diyk	SF
>adoyAk	BP
diymAs	SF
dayAmiys	BP
diyn	SF
>adoyAn	BP
diynAr	SF
danAniyr	BP
diywAn	SF
dawAwiyn	BP
dub~	SF
>adobAb	BP
dub~	SF
dibabap	BP
dubor	SF
>adobAr	BP
duk~An	SF
dakAkiyn	BP
dulofiyn	SF
dalAfiyn	BP
dum~al	SF
damAmil	BP
dumoluj	SF
damAlij	BP
duqomAq	SF
daqAmiyq	BP
duroj	SF
>adorAj	BP
duroj	SF
duruwj	BP
dusotuwr	SF
dasAtiyr	BP
duwd	SF
diydAn	BP
Ea$A'	SF
>aEo$iyap	BP
EabA'	SF
>aEobi}ap	BP
EaDud	SF
>aEoDAd	BP
EAhil	SF
EawAhil	BP
EAhin	SF
EawAhin	BP
EAhir	SF
Euh~Ar	BP
EA}iq	SF
EawA}iq	BP
Ea$iyrap	SF
Ea$A}ir	BP
EAliyap	SF
EawAliy	BP
Eam~	SF
Eumuwm	BP
EAm	SF
>aEowAm	BP
Eam~	SF
Eumuwm	BP
Eamiyd	SF
EumadA'	BP
Eamuwd	SF
>aEomidap	BP
EAmuwd	SF
EawAmiyd	BP
EAnis	SF
EawAnis	BP
Eanobar	SF
EanAbir	BP
Eanokabuwt	SF
EanAkib	BP
Eanoz	SF
>aEonuz	BP
Eanoz	SF
EinAz	BP
Eanoz	SF
Eunuwz	BP
Ea*orA'	SF
Ea*AraY	BP
Eaq~Ar	SF
EaqAqiyr	BP
EAqibap	SF
EawAqib	BP
Eaqiyd	SF
EuqadA'	BP
Eaqiyq	SF
>aEiq~ap	BP
Eaqod	SF
Euquwd	BP
Eaqol	SF
Euquwl	BP
EariyDap	SF
EarA}iD	BP
Eariyf	SF
EurafA'	BP
Eariyn	SF
Eurun	BP
Eariynap	SF
EarA}in	BP
Eariys	SF
EurosAn	BP
Earo$	SF
>aEorA$	BP
Earo$	SF
Euruw$	BP
EaSab	SF
>aEoSAb	BP
EASimap	SF
EawASim	BP
EaSiydap	SF
EaSA}id	BP
Easoqal	SF
EasAqil	BP
EaSor	SF
>aEoSAr	BP
EaSor	SF
>aEoSur	BP
EaSor	SF
EuSuwr	BP
Eat~Al	SF
Eat~Alap	BP
EAtiq	SF
EawAtiq	BP
EaTiy~ap	SF
EaTAyA	BP
Eawon	SF
>aEowAn	BP
EaZiymap	SF
EaZA}im	BP
EaZom	SF
EiZAm	BP
Eiborap	SF
Eibar	BP
Eiforiyt	SF
EafAriyt	BP
Eiloj	SF
Euluwj	BP
EilowAn	SF
EalAwiyn	BP
EimAd	SF
Eumud	BP
EimAmap	SF
EamA}im	BP
EimolAq	SF
EamAliqap	BP
Ei*oq	SF
>aEo*Aq	BP
Ei*oq	SF
Eu*uwq	BP
EironAs	SF
EarAniys	BP
Eiroq	SF
Euruwq	BP
EirozAl	SF
EarAziyl	BP
EiTAf	SF
>aEoTifap	BP
EiTof	SF
>aEoTAf	BP
Eizobap	SF
Eizab	BP
Eu$~	SF
>aEo$A$	BP
Eu$~ap	SF
Eu$a$	BP
Eumodap	SF
Eumad	BP
Eumoq	SF
>aEomAq	BP
Eunoq	SF
>aEonAq	BP
Eunoquwd	SF
EanAqiyd	BP
EunoSur	SF
EanASir	BP
EunowAn	SF
EanAwiyn	BP
Eu$ob	SF
>aEo$Ab	BP
Eu*or	SF
>aEo*Ar	BP
EuqAb	SF
EiqobAn	BP
Euqobuwl	SF
EaqAbiyl	BP
Euqodap	SF
Euqad	BP
Eurobuwn	SF
EarAbiyn	BP
Eurojuwn	SF
EarAjiyn	BP
Euroquwb	SF
EarAqiyb	BP
Euros	SF
>aEorAs	BP
Eurowap	SF
EuraY	BP
EuSofuwr	SF
EaSAfiyr	BP
Eusoluj	SF
EasAlij	BP
Eusoluwj	SF
EasAliyj	BP
Eusoquwl	SF
EasAqiyl	BP
EuTol	SF
>aEoTAl	BP
Euwd	SF
>aEowAd	BP
Euwd	SF
EiydAn	BP
fad~An	SF
>afodinap	BP
fAdiHap	SF
fawAdiH	BP
fAdin	SF
fawAdin	BP
fahod	SF
>afohud	BP
fahod	SF
fuhuwd	BP
faHol	SF
fuHuwl	BP
fA}idap	SF
fawA}id	BP
fA}idap	SF
fawA}id	BP
fAjiEap	SF
fawAjiE	BP
fajiyEap	SF
fajA}iE	BP
fak~	SF
fukuwk	BP
fak~	SF
fukuwk	BP
fAkihap	SF
fawAkih	BP
fAkuwn	SF
fawAkiyn	BP
fal~	SF
fuluwl	BP
fal~	SF
fuluwl	BP
falaj	SF
>afolAj	BP
falak	SF
>afolAk	BP
fAliq	SF
fawAliq	BP
faloE	SF
fuluwE	BP
faloj	SF
fuluwj	BP
faloq	SF
fuluwq	BP
faluwkap	SF
falA}ik	BP
fan~	SF
funuwn	BP
fan~	SF
funuwn	BP
fanan	SF
>afonAn	BP
fAnuws	SF
fawAniys	BP
fa>ol	SF
fu&uwl	BP
fa>os	SF
fu&uws	BP
fAqiE	SF
fawAqiE	BP
faqiyh	SF
fuqahA'	BP
fara>	SF
>aforA'	BP
faras	SF
>aforAs	BP
fariydap	SF
farA}id	BP
fariyDap	SF
farA}iD	BP
fariysap	SF
farA}is	BP
fariySap	SF
farA}iS	BP
farod	SF
furuwd	BP
faroE	SF
furuwE	BP
farofuwr	SF
farAfiyr	BP
faroj	SF
furuwj	BP
farosax	SF
farAsix	BP
farox	SF
>aforAx	BP
farox	SF
>aforux	BP
farox	SF
furuwx	BP
far~uwj	SF
farAriyj	BP
faS~	SF
fuSuwS	BP
faS~	SF
fuSuwS	BP
faSiyl	SF
faSA}il	BP
fasiylap	SF
fasA}il	BP
fasofas	SF
fasAfis	BP
fataY	SF
fitoyAn	BP
fataY	SF
fitoyap	BP
faTiyrap	SF
faTA}ir	BP
faTiysap	SF
faTA}is	BP
fatofuwtap	SF
fatAfiyt	BP
fatowaY	SF
fatAwiy	BP
fatowaY	SF
fatAwaY	BP
fawoj	SF
>afowAj	BP
fawot	SF
>afowAt	BP
fax~	SF
fuxuwx	BP
fax~	SF
fuxuwx	BP
faxo*	SF
>afoxA*	BP
fayo'	SF
>afoyA'	BP
fayo'	SF
>afoyA}	BP
fayo'	SF
>afoyA&	BP
fayo'	SF
fuyuw'	BP
fayofA'	SF
fayAfiy	BP
fayolaj	SF
fayAlij	BP
fayolaj	SF
fayAlij	BP
faZ~	SF
>afoZAZ	BP
faZiyEap	SF
faZA}iE	BP
faz~uwrap	SF
fawAziyr	BP
fi$~ap	SF
fi$a$	BP
fihoris	SF
fahAris	BP
filofil	SF
falAfil	BP
filojAn	SF
falAjiyn	BP
filos	SF
fuluws	BP
filow	SF
filA'	BP
filow	SF
filA}	BP
finA'	SF
>afoniyap	BP
finojAl	SF
fanAjiyl	BP
finojAn	SF
fanAjiyn	BP
finoTAs	SF
fanATiys	BP
firoEawon	SF
farAEinap	BP
firomAn	SF
farAmiyn	BP
firoqap	SF
firaq	BP
firoyap	SF
firaY	BP
firoyap	SF
firaY	BP
fitor	SF
>afotAr	BP
fiTorap	SF
fiTar	BP
fiyl	SF
>afoyAl	BP
fiylom	SF
>afolAm	BP
fu&Ad	SF
>afo}idap	BP
fuloT	SF
>afolAt	BP
fuloT	SF
>afolAT	BP
funoduq	SF
fanAdiq	BP
fuq~AEap	SF
faqAqiyE	BP
furo$ap	SF
fura$	BP
furon	SF
>aforAn	BP
furoSap	SF
furaS	BP
fusotAn	SF
fasAtiyn	BP
fusoTAT	SF
fasATiyT	BP
fuTor	SF
fuTuwr	BP
fuwh	SF
>afowAh	BP
fuwTap	SF
fuwaT	BP
gadiy~ap	SF
gadAyA	BP
gadiyr	SF
gudorAn	BP
gadiyrap	SF
gadA}ir	BP
gaDon	SF
guDuwn	BP
gA}ilap	SF
gawA}il	BP
gA}ilap	SF
gawA}il	BP
galaq	SF
>agolAq	BP
galoyuwn	SF
galAyiyn	BP
gAr	SF
giyrAn	BP
gArib	SF
gawArib	BP
gariyb	SF
>agorAb	BP
gariysap	SF
garA}is	BP
gariyzap	SF
garA}iz	BP
gawor	SF
>agowAr	BP
gayol	SF
guyuwl	BP
gayomap	SF
giyAm	BP
gazAl	SF
gizolAn	BP
gi$A'	SF
>ago$iyap	BP
gilAlap	SF
galA}il	BP
gimod	SF
>agomAd	BP
giro$	SF
guruw$	BP
girobAl	SF
garAbiyl	BP
giToriyf	SF
gaTArifap	BP
giToriyf	SF
gaTAriyf	BP
gud~ap	SF
gudad	BP
gudofap	SF
gudaf	BP
gul~	SF
>agolAl	BP
gulAm	SF
gilomAn	BP
gurAb	SF
>agoribap	BP
gurAb	SF
girobAn	BP
gurod	SF
guruwd	BP
gurofap	SF
guraf	BP
guronuwq	SF
garAniyq	BP
guwayo$ap	SF
gawA}i$	BP
guwl	SF
>agowAl	BP
guwl	SF
giylAn	BP
Hab~	SF
Hubuwb	BP
Hab~	SF
Hubuwb	BP
Habol	SF
>aHobAl	BP
Habol	SF
>aHobul	BP
Habol	SF
HibAl	BP
Habol	SF
Hubuwl	BP
Habor	SF
>aHobAr	BP
hadaf	SF
>ahodAf	BP
HADinap	SF
HawADin	BP
hadiy~ap	SF
hadAyA	BP
HaDiyD	SF
HuDuD	BP
Hadiyqap	SF
HadA}iq	BP
HaDiyrap	SF
HaDA}ir	BP
HAfiz	SF
HawAfiz	BP
HA}iT	SF
HawA}iT	BP
Hajalap	SF
HijAl	BP
haj~An	SF
haj~Anap	BP
Hajar	SF
>aHojAr	BP
Hajar	SF
HijArap	BP
Hajar	SF
HijAr	BP
Hajol	SF
>aHojAl	BP
Hajol	SF
Hujuwl	BP
Hajom	SF
>aHojAm	BP
Hakam	SF
Huk~Am	BP
HAkim	SF
Huk~Am	BP
HAl	SF
>aHowAl	BP
Hal~	SF
Huluwl	BP
Hal~	SF
Huluwl	BP
Hal~ap	SF
Hilal	BP
Halaq	SF
HuloqAn	BP
hAlik	SF
hawAlik	BP
Haliylap	SF
HalA}il	BP
halofuwt	SF
halAfiyt	BP
halohuwlap	SF
halAhiyl	BP
ham~	SF
humuwm	BP
ham~	SF
humuwm	BP
Ham~Ar	SF
Ham~Arap	BP
hAmi$	SF
hawAmi$	BP
hAmil	SF
hum~al	BP
HamoD	SF
>aHomAD	BP
Hana$	SF
>aHonA$	BP
Hanak	SF
>aHonAk	BP
Haniy~ap	SF
HanAyA	BP
hano$iyr	SF
hanA$iyr	BP
Hanojar	SF
HanAjir	BP
HanoTuwr	SF
HanATiyr	BP
HAnuwt	SF
HawAniyt	BP
Haqiydap	SF
HaqA}id	BP
Haqol	SF
Huquwl	BP
Haqow	SF
>aHoqA'	BP
Haqow	SF
HiqA'	BP
Haram	SF
>aHorAm	BP
Hariyq	SF
HarA}iq	BP
Harobap	SF
HirAb	BP
Harof	SF
>aHoruf	BP
Harof	SF
Huruwf	BP
haroTuwqiy~	SF
harATiqap	BP
HAs~ap	SF
HawAs~	BP
HaSiyr	SF
HaSA}ir	BP
HAsuwb	SF
HawAsiyb	BP
hAtif	SF
hawAtif	BP
Hatof	SF
Hutuwf	BP
hawiys	SF
>ahowisap	BP
Hawo$	SF
>aHowA$	BP
Hawo$	SF
Hiy$An	BP
HawoD	SF
>aHowAD	BP
HawoD	SF
HiyAD	BP
hawodaj	SF
hawAdij	BP
hawodaj	SF
hawAdij	BP
hawodaj	SF
hawAdij	BP
hawor	SF
>ahowAr	BP
hawotap	SF
huwat	BP
Hay~	SF
>aHoyA'	BP
Hay~	SF
>aHoyA}	BP
Hay~	SF
>aHoyA&	BP
hayokal	SF
hayAkil	BP
hayokal	SF
hayAkil	BP
HaZiy~ap	SF
HaZAyA	BP
haziymap	SF
hazA}im	BP
HaZiyrap	SF
HaZA}ir	BP
HibAlap	SF
HabA}il	BP
Hibos	SF
>aHobAs	BP
Hidoj	SF
>aHodAj	BP
Hidoj	SF
Huduwj	BP
HifAf	SF
>aHif~ap	BP
HijAb	SF
>aHojibap	BP
HijAb	SF
Hujub	BP
hilAl	SF
>ahil~ap	BP
hilob	SF
>aholAb	BP
Hilof	SF
>aHolAf	BP
Hiloyap	SF
HilaY	BP
Hiloyap	SF
HilaY	BP
HimAr	SF
>aHomirap	BP
HimAr	SF
Hamiyr	BP
Hinodis	SF
HanAdis	BP
hir~	SF
hirarap	BP
hir~ap	SF
hirar	BP
Hiro$	SF
>aHorA$	BP
Hiro$	SF
Huruw$	BP
Hirofap	SF
Hiraf	BP
Hiroz	SF
>aHorAz	BP
HiSAn	SF
>aHoSinap	BP
HiSAn	SF
HuSun	BP
HiSon	SF
HuSuwn	BP
Hit~ap	SF
Hitat	BP
HitAr	SF
Hutur	BP
HiTomap	SF
HiTam	BP
Hiylap	SF
Hiyal	BP
Hizob	SF
>aHozAb	BP
Hubokap	SF
Hubak	BP
hudohud	SF
hadAhid	BP
Huforap	SF
Hufar	BP
Huk~ap	SF
Hukak	BP
Hukom	SF
>aHokAm	BP
Hulom	SF
>aHolAm	BP
Huloquwm	SF
HalAqiym	BP
Hunojuwr	SF
HanAjiyr	BP
huroy	SF
>ahorA'	BP
huroy	SF
>ahorA}	BP
huroy	SF
>ahorA&	BP
Huwt	SF
HiytAn	BP
Huzomap	SF
Huzam	BP
$ibol	SF
>a$obAl	BP
<iboliys	SF
>abAlisap	BP
<iboliys	SF
>abAliys	BP
<iborap	SF
<ibar	BP
<iboriyq	SF
>abAriqap	BP
<iboriyq	SF
>abAriyq	BP
<iboziym	SF
>abAziym	BP
$idoq	SF
>a$odAq	BP
$idoyAq	SF
$adAyiqap	BP
$iEob	SF
$iEAb	BP
<ifo$iyn	SF
>afA$iyn	BP
<iforiyz	SF
>afAriyz	BP
<ihAb	SF
>uhub	BP
$ihAb	SF
$uhobAn	BP
$ihAb	SF
$uhub	BP
*ihon	SF
>a*ohAn	BP
$ikArap	SF
$akA}ir	BP
<ikoliyl	SF
>akAliyl	BP
$il~ap	SF
$ilal	BP
$ilow	SF
>a$olA'	BP
$ilow	SF
>a$olA}	BP
$ilow	SF
>a$olA&	BP
<imAm	SF
>a}im~ap	BP
*imAm	SF
>a*im~ap	BP
<imAm	SF
>ayim~ap	BP
<inA'	SF
|niyap	BP
<inobiyq	SF
>anAbiyq	BP
<inojiyl	SF
>anAjiyl	BP
*i}ob	SF
*i}Ab	BP
<i$obiyn	SF
>a$Abiyn	BP
<i$ofaY	SF
>a$Afiy	BP
<i$ofaY	SF
>a$Afiy	BP
<iqoliym	SF
>aqAliym	BP
$irAE	SF
>a$oriEap	BP
*irAE	SF
>a*oruE	BP
*irAE	SF
*uroEAn	BP
$iro$	SF
$uruw$	BP
$iroyAn	SF
$arAyiyn	BP
<iSobaE	SF
>aSAbiE	BP
<iSobaE	SF
>aSAbiE	BP
<isofiyn	SF
>asAfiyn	BP
<isokAfiy~	SF
>asAkifap	BP
<isokilap	SF
>asAkil	BP
{isom	SF
>asomA'	BP
{isom	SF
>asomA}	BP
{isom	SF
>asomA&	BP
<isowAr	SF
>asAwirap	BP
$itA'	SF
>a$otiyap	BP
<izAr	SF
>uzur	BP
<izomiyl	SF
>azAmiyl	BP
ja*aE	SF
ju*oEAn	BP
jabal	SF
>ajobAl	BP
jabal	SF
jibAl	BP
jabAn	SF
jubanA'	BP
jabiyrap	SF
jabA}ir	BP
jaboH	SF
>ajobAH	BP
jadaE	SF
jidoEAn	BP
jadav	SF
>ajodAv	BP
jadiylap	SF
jadA}il	BP
jadowal	SF
jadAwil	BP
jadoy	SF
jidoyAn	BP
jaEobap	SF
jiEAb	BP
jafon	SF
>ajofAn	BP
jafon	SF
jufuwn	BP
jaHo$	SF
jiHA$	BP
jaHo$	SF
jiHo$An	BP
jaHofal	SF
jaHAfil	BP
jA}izap	SF
jawA}iz	BP
jA}izap	SF
jawA}iz	BP
jaliy~ap	SF
jalAyA	BP
jalomad	SF
jalAmid	BP
jamal	SF
>ajomAl	BP
jamal	SF
jimAl	BP
janAH	SF
>ajoniHap	BP
jAnib	SF
jawAnib	BP
jAniH	SF
jawAniH	BP
janob	SF
>ajonAb	BP
janodal	SF
janAdil	BP
ja*owap	SF
ji*A'	BP
ja*owap	SF
ji*aY	BP
jAr	SF
jiyrAn	BP
jaras	SF
>ajorAs	BP
jariydap	SF
jarA}id	BP
jariymap	SF
jarA}im	BP
jarobuwE	SF
jarAbiyE	BP
jarodal	SF
jarAdil	BP
jarokasiy~	SF
jarAkisap	BP
jAruw$ap	SF
jawAriy$	BP
jAruwr	SF
jawAriyr	BP
jawAb	SF
>ajowibap	BP
jawosaq	SF
jawAsiq	BP
jawosaq	SF
jawAsiq	BP
jawosaq	SF
jawAsiq	BP
jaziyrap	SF
juzur	BP
jidAr	SF
judorAn	BP
jinos	SF
>ajonAs	BP
jinoziyr	SF
janAziyr	BP
ji*oE	SF
>ajo*AE	BP
ji*oE	SF
ju*uwE	BP
ji*ol	SF
>ajo*Al	BP
ji*ol	SF
ju*uwl	BP
ji*om	SF
>ajo*Am	BP
ji*or	SF
ju*uwr	BP
jirAb	SF
>ajoribap	BP
jirAb	SF
jurub	BP
jisom	SF
>ajosAm	BP
jisor	SF
jusuwr	BP
jivoliyq	SF
javAliqap	BP
jiyfap	SF
jiyaf	BP
jiyl	SF
>ajoyAl	BP
jub~	SF
>ajobAb	BP
jub~ap	SF
jubab	BP
judojud	SF
jadAjid	BP
juHor	SF
>ajoHAr	BP
juHor	SF
juHuwr	BP
jul~aY	SF
julal	BP
julojul	SF
jalAjil	BP
julomuwd	SF
jalAmiyd	BP
jumojumap	SF
jamAjim	BP
jumolap	SF
jumal	BP
jun~Az	SF
janAniyz	BP
junodub	SF
janAdib	BP
junoHap	SF
junaH	BP
junok	SF
junuwk	BP
jurof	SF
juruwf	BP
jurom	SF
>ajorAm	BP
jurom	SF
juruwm	BP
juron	SF
>ajorAn	BP
juronAl	SF
jarAniyl	BP
jurovuwm	SF
jarAviym	BP
jurozap	SF
juraz	BP
juv~ap	SF
juvav	BP
juwn	SF
>ajowAn	BP
juwrap	SF
juwar	BP
juzo'	SF
>ajozA'	BP
juzo'	SF
>ajozA}	BP
juzo'	SF
>ajozA&	BP
kabid	SF
>akobAd	BP
kabo$	SF
>akobA$	BP
kabo$	SF
kibA$	BP
kabol	SF
kubuwl	BP
kAbuws	SF
kawAbiys	BP
kab~uwt	SF
kabAbiyt	BP
kaf~	SF
kufuwf	BP
kaf~	SF
kufuwf	BP
kafan	SF
>akofAn	BP
kAHil	SF
kawAHil	BP
kAhiyap	SF
kawAhiy	BP
kahof	SF
kuhuwf	BP
kahorab	SF
kahArib	BP
kala>	SF
>akolA'	BP
kalob	SF
kilAb	BP
kalokal	SF
kalAkil	BP
kalom	SF
kuluwm	BP
kan~	SF
>akonAn	BP
kan~ap	SF
kanA}in	BP
kaniyf	SF
kunuf	BP
kaniys	SF
kanA}is	BP
kaniysap	SF
kanA}is	BP
kanoz	SF
kunuwz	BP
kAnuwn	SF
kawAniyn	BP
ka$oka$	SF
ka$Aki$	BP
kAriE	SF
kawAriE	BP
kArivap	SF
kawAriv	BP
kariyhap	SF
karA}ih	BP
kariymap	SF
karA}im	BP
karob	SF
kuruwb	BP
karom	SF
kuruwm	BP
kAs	SF
>akowAs	BP
katif	SF
>akotAf	BP
katiybap	SF
katA}ib	BP
katokuwt	SF
katAkiyt	BP
kaviyb	SF
kuvobAn	BP
kaviyb	SF
kuvub	BP
kawokab	SF
kawAkib	BP
kawokab	SF
kawAkib	BP
kawokab	SF
kawAkib	BP
kawom	SF
>akowAm	BP
kayod	SF
kiyAd	BP
kayokap	SF
kayAkiy	BP
kayokap	SF
kayAkiy	BP
kayol	SF
>akoyAl	BP
kiboriyt	SF
kabAriyt	BP
kif~ap	SF
kifaf	BP
kiro$	SF
>akorA$	BP
kiro$	SF
kuruw$	BP
kirobAl	SF
karAbiyl	BP
kirodAn	SF
karAdiyn	BP
kitAb	SF
kutub	BP
kiys	SF
>akoyAs	BP
kuboriy	SF
kabAriy	BP
kudos	SF
>akodAs	BP
kuEoburap	SF
kaEAbir	BP
kul~Ab	SF
kalAliyb	BP
kulofap	SF
kulaf	BP
kumosAriy~	SF
kumosAriy~ap	BP
kunodurap	SF
kanAdir	BP
kunoyap	SF
kunaY	BP
ku$ok	SF
>ako$Ak	BP
kurobAj	SF
karAbiyj	BP
kurobap	SF
kurab	BP
kurokiy~	SF
karAkiy~	BP
kurokiy~	SF
karAkiy~	BP
kuroniy$	SF
karAniy$	BP
kurosiy~	SF
karAsiy~	BP
kurosiy~	SF
karAsiy~	BP
kut~Ab	SF
katAtiyb	BP
kutolap	SF
kutal	BP
kuw$ap	SF
kuwa$	BP
kuwArap	SF
kawA}ir	BP
kuwE	SF
>akowAE	BP
kuwE	SF
kiyEAn	BP
kuwmosAriy~	SF
kuwmosAriy~ap	BP
kuwx	SF
>akowAx	BP
kuwz	SF
>akowAz	BP
kuwz	SF
kiyzAn	BP
labab	SF
>alobAb	BP
laEob	SF
>aloEAb	BP
laEolaE	SF
laEAliE	BP
lafoZ	SF
>alofAZ	BP
lagom	SF
>alogAm	BP
lAHiqap	SF
lawAHiq	BP
lAHiZap	SF
lawAHiZ	BP
laHod	SF
>aloHAd	BP
laHod	SF
luHuwd	BP
laHon	SF
>aloHAn	BP
lA*iEap	SF
lawA*iE	BP
lA}im	SF
luw~Am	BP
lakan	SF
>alokAn	BP
lam~ap	SF
limAm	BP
laqab	SF
>aloqAb	BP
laqiyT	SF
luqaTA'	BP
lASiqap	SF
lawASiq	BP
laTiyfap	SF
laTA}if	BP
lawolab	SF
lawAlib	BP
lawolab	SF
lawAlib	BP
lawolab	SF
lawAlib	BP
lawon	SF
>alowAn	BP
layov	SF
luyuwv	BP
libodap	SF
libad	BP
liHAf	SF
>aloHifap	BP
liHAf	SF
luHuf	BP
lijAm	SF
>alojimap	BP
lijAm	SF
lujum	BP
lisAn	SF
>alosinap	BP
lisAn	SF
>alosun	BP
livAm	SF
luvum	BP
luEobap	SF
luEab	BP
lugod	SF
>alogAd	BP
lugod	SF
luguwd	BP
lugoduwd	SF
lagAdiyd	BP
lugoz	SF
>alogAz	BP
luqoTap	SF
luqaT	BP
maboda>	SF
mabAdi}	BP
maboda>	SF
mabAdi}	BP
maboEav	SF
mabAEiv	BP
maboEav	SF
mabAEiv	BP
maboHav	SF
mabAHiv	BP
maboHav	SF
mabAHiv	BP
mabolag	SF
mabAlig	BP
mabolag	SF
mabAlig	BP
mabonaY	SF
mabAniy	BP
mabonaY	SF
mabAniy	BP
mabosim	SF
mabAsim	BP
madad	SF
>amodAd	BP
maDAfap	SF
maDA}if	BP
maDAfap	SF
maDA}if	BP
mAd~ap	SF
mawAd~	BP
madiyH	SF
madA}iH	BP
madiyH	SF
madA}iH	BP
madobag	SF
madAbig	BP
madobag	SF
madAbig	BP
maDobaTap	SF
maDAbiT	BP
maDobaTap	SF
maDAbiT	BP
madofan	SF
madAfin	BP
madofan	SF
madAfin	BP
maDojaE	SF
maDAjiE	BP
maDojaE	SF
maDAjiE	BP
madomaE	SF
madAmiE	BP
madomaE	SF
madAmiE	BP
maDomuwn	SF
maDAmiyn	BP
maDomuwn	SF
maDAmiyn	BP
madoraj	SF
madArij	BP
madoraj	SF
madArij	BP
madorasap	SF
madAris	BP
madorasap	SF
madAris	BP
maDorib	SF
maDArib	BP
madoxal	SF
madAxil	BP
madoxal	SF
madAxil	BP
maEo$ar	SF
maEA$ir	BP
maEo$ar	SF
maEA$ir	BP
maEobar	SF
maEAbir	BP
maEobar	SF
maEAbir	BP
maEohad	SF
maEAhid	BP
maEohad	SF
maEAhid	BP
maEo*irap	SF
maEA*ir	BP
maEoqid	SF
maEAqid	BP
maEoqil	SF
maEAqil	BP
maEoraj	SF
maEArij	BP
maEoraj	SF
maEArij	BP
maEorakap	SF
maEArik	BP
maEorakap	SF
maEArik	BP
maEoriD	SF
maEAriD	BP
maEoruwD	SF
maEAriyD	BP
maEoruwD	SF
maEAriyD	BP
maEoSiyap	SF
maEASiy	BP
mAEuwn	SF
mawAEiyn	BP
mafohuwm	SF
mafAhiym	BP
mafohuwm	SF
mafAhiym	BP
maforaH	SF
mafAriH	BP
maforaH	SF
mafAriH	BP
maforaj	SF
mafArij	BP
maforaj	SF
mafArij	BP
maforax	SF
mafArix	BP
maforax	SF
mafArix	BP
maforazap	SF
mafAriz	BP
maforazap	SF
mafAriz	BP
mafosadap	SF
mafAsid	BP
mafosadap	SF
mafAsid	BP
mafoSil	SF
mafASil	BP
mafoxarap	SF
mafAxir	BP
mafoxarap	SF
mafAxir	BP
magolaTap	SF
magAliT	BP
magolaTap	SF
magAliT	BP
magomaz	SF
magAmiz	BP
magomaz	SF
magAmiz	BP
magoraz	SF
magAriz	BP
magoraz	SF
magAriz	BP
magosal	SF
magAsil	BP
magosal	SF
magAsil	BP
magoTis	SF
magATis	BP
magozaY	SF
magAziy	BP
magozaY	SF
magAziy	BP
maHo$a$	SF
maHA$i$	BP
maHo$a$	SF
maHA$i$	BP
maHobas	SF
maHAbis	BP
maHobas	SF
maHAbis	BP
mahobiT	SF
mahAbiT	BP
mahod	SF
muhuwd	BP
maHoDan	SF
maHADin	BP
maHoDan	SF
maHADin	BP
maHofil	SF
maHAfil	BP
maHojar	SF
maHAjir	BP
maHojar	SF
maHAjir	BP
maHojir	SF
maHAjir	BP
maHokamap	SF
maHAkim	BP
maHokamap	SF
maHAkim	BP
maHomadap	SF
maHAmid	BP
maHomadap	SF
maHAmid	BP
maHonaY	SF
maHAniy	BP
maHonaY	SF
maHAniy	BP
maHoramap	SF
maHArim	BP
maHoramap	SF
maHArim	BP
mahoraq	SF
mahAriq	BP
mahoraq	SF
mahAriq	BP
mahowaY	SF
mahAwiy	BP
mahowaY	SF
mahAwiy	BP
mA}id	SF
mayodaY	BP
mA}idap	SF
mawA}id	BP
mA}idap	SF
mawA}id	BP
mA}iE	SF
mawA}iE	BP
ma$iyj	SF
>amo$Aj	BP
mAjil	SF
mawAjil	BP
majobaY	SF
majAbiy	BP
majobaY	SF
majAbiy	BP
majod	SF
>amojAd	BP
majolis	SF
majAlis	BP
majomaE	SF
majAmiE	BP
majomaE	SF
majAmiE	BP
majonaY	SF
majAniy	BP
majonaY	SF
majAniy	BP
majonuwn	SF
majAniyn	BP
majonuwn	SF
majAniyn	BP
majoraY	SF
majAriy	BP
majoraY	SF
majAriy	BP
majozarap	SF
majAzir	BP
majozarap	SF
majAzir	BP
mAjuwr	SF
mawAjiyr	BP
makAn	SF
>amokinap	BP
makoman	SF
makAmin	BP
makoman	SF
makAmin	BP
makoram	SF
makArim	BP
makoram	SF
makArim	BP
makos	SF
mukuws	BP
makosab	SF
makAsib	BP
makosab	SF
makAsib	BP
makosir	SF
makAsir	BP
makotuwb	SF
makAtiyb	BP
makotuwb	SF
makAtiyb	BP
mAkuwk	SF
mawAkiyk	BP
mak~uwk	SF
makAkiyk	BP
mAl	SF
>amowAl	BP
malik	SF
>amolAk	BP
maliy~ap	SF
malAyA	BP
maliyk	SF
mulakA'	BP
malo>ak	SF
malA}ik	BP
malo>ak	SF
malA}ik	BP
maloEab	SF
malAEib	BP
maloEab	SF
malAEib	BP
malohaY	SF
malAhiy	BP
malohaY	SF
malAhiy	BP
maloHaZ	SF
malAHiZ	BP
maloHaZ	SF
malAHiZ	BP
maloja>	SF
malAji}	BP
maloja>	SF
malAji}	BP
malomaH	SF
malAmiH	BP
malomaH	SF
malAmiH	BP
malomas	SF
malAmis	BP
malomas	SF
malAmis	BP
maloqaY	SF
malAqiy	BP
maloqaY	SF
malAqiy	BP
malozamap	SF
malAzim	BP
malozamap	SF
malAzim	BP
mamo$aY	SF
mamA$iy	BP
mamo$aY	SF
mamA$iy	BP
mamolaHap	SF
mamAliH	BP
mamolaHap	SF
mamAliH	BP
mamolakap	SF
mamAlik	BP
mamolakap	SF
mamAlik	BP
mamoluwk	SF
mamAliyk	BP
mamoluwk	SF
mamAliyk	BP
mAniE	SF
mawAniE	BP
mano$aT	SF
manA$iT	BP
mano$aT	SF
manA$iT	BP
manobaE	SF
manAbiE	BP
manobaE	SF
manAbiE	BP
manobat	SF
manAbit	BP
manobat	SF
manAbit	BP
manodab	SF
manAdib	BP
manodab	SF
manAdib	BP
manodiyl	SF
manAdiyl	BP
manodiyl	SF
manAdiyl	BP
manoEaY	SF
manAEiy	BP
manoEaY	SF
manAEiy	BP
manofa*	SF
manAfi*	BP
manofa*	SF
manAfi*	BP
manohaj	SF
manAhij	BP
manohaj	SF
manAhij	BP
manoHal	SF
manAHil	BP
manoHal	SF
manAHil	BP
manohal	SF
manAhil	BP
manohal	SF
manAhil	BP
manoHaY	SF
manAHiy	BP
manoHaY	SF
manAHiy	BP
manojam	SF
manAjim	BP
manojam	SF
manAjim	BP
manojAp	SF
manAjiy	BP
manokib	SF
manAkib	BP
manoqaE	SF
manAqiE	BP
manoqaE	SF
manAqiE	BP
manoqal	SF
manAqil	BP
manoqal	SF
manAqil	BP
manosar	SF
manAsir	BP
manoSar	SF
manASir	BP
manosar	SF
manAsir	BP
manoSar	SF
manASir	BP
manoSib	SF
manASib	BP
manosik	SF
manAsik	BP
manosim	SF
manAsim	BP
manosuwb	SF
manAsiyb	BP
manosuwb	SF
manAsiyb	BP
manoxar	SF
manAxir	BP
manoxar	SF
manAxir	BP
manoZar	SF
manAZir	BP
manoZar	SF
manAZir	BP
manozil	SF
manAzil	BP
manozilap	SF
manAzil	BP
ma*obaHap	SF
ma*AbiH	BP
ma*obaHap	SF
ma*AbiH	BP
ma>odubap	SF
ma|dib	BP
ma$oEal	SF
ma$AEil	BP
ma$oEal	SF
ma$AEil	BP
ma$ogal	SF
ma$Agil	BP
ma$ogal	SF
ma$Agil	BP
ma$ohad	SF
ma$Ahid	BP
ma$ohad	SF
ma$Ahid	BP
ma$olaH	SF
ma$AliH	BP
ma$olaH	SF
ma$AliH	BP
ma>oman	SF
ma|min	BP
ma$oq	SF
>amo$Aq	BP
ma>orab	SF
ma|rib	BP
ma$oraf	SF
ma$Arif	BP
ma$oraf	SF
ma$Arif	BP
ma>osad	SF
ma|sid	BP
ma$otal	SF
ma$Atil	BP
ma$otal	SF
ma$Atil	BP
ma>otam	SF
ma|tim	BP
ma>otaY	SF
ma|tiy	BP
ma$otaY	SF
ma$Atiy	BP
ma$otaY	SF
ma$Atiy	BP
ma>ovam	SF
ma|vim	BP
ma>ovarap	SF
ma|vir	BP
ma>oziq	SF
ma|ziq	BP
maqobar	SF
maqAbir	BP
maqobar	SF
maqAbir	BP
maqobiD	SF
maqAbiD	BP
maqoEad	SF
maqAEid	BP
maqoEad	SF
maqAEid	BP
maqohaY	SF
maqAhiy	BP
maqohaY	SF
maqAhiy	BP
maqolab	SF
maqAlib	BP
maqolab	SF
maqAlib	BP
maqolaE	SF
maqAliE	BP
maqolaE	SF
maqAliE	BP
maqomar	SF
maqAmir	BP
maqomar	SF
maqAmir	BP
maqorab	SF
maqArib	BP
maqorab	SF
maqArib	BP
maqoSaf	SF
maqASif	BP
maqoSaf	SF
maqASif	BP
maqosam	SF
maqAsim	BP
maqosam	SF
maqAsim	BP
maqoSuwS	SF
maqASiyS	BP
maqoSuwS	SF
maqASiyS	BP
maqoTaE	SF
maqATiE	BP
maqoTaE	SF
maqATiE	BP
maqoTaf	SF
maqATif	BP
maqoTaf	SF
maqATif	BP
maqotal	SF
maqAtil	BP
maqotal	SF
maqAtil	BP
maraD	SF
>amorAD	BP
maro>aY	SF
marA}iy	BP
maro>aY	SF
marA}iy	BP
marobaE	SF
marAbiE	BP
marobaE	SF
marAbiE	BP
maroE	SF
>amorAE	BP
maroE	SF
>amoruE	BP
marofaE	SF
marAfiE	BP
marofaE	SF
marAfiE	BP
maroHalap	SF
marAHil	BP
maroHalap	SF
marAHil	BP
maroham	SF
marAhim	BP
maroham	SF
marAhim	BP
marojuwHap	SF
marAjiyH	BP
marokab	SF
marAkib	BP
marokab	SF
marAkib	BP
marokaz	SF
marAkiz	BP
marokaz	SF
marAkiz	BP
marokuwb	SF
marAkiyb	BP
marokuwb	SF
marAkiyb	BP
maroqab	SF
marAqib	BP
maroqab	SF
marAqib	BP
maroqad	SF
marAqid	BP
maroqad	SF
marAqid	BP
maroqaS	SF
marAqiS	BP
maroqaS	SF
marAqiS	BP
maroSad	SF
marASid	BP
maroSad	SF
marASid	BP
marosaH	SF
marAsiH	BP
marosaH	SF
marAsiH	BP
marosaY	SF
marAsiy	BP
marosaY	SF
marAsiy	BP
marosuwm	SF
marAsiym	BP
marosuwm	SF
marAsiym	BP
marotabap	SF
marAtib	BP
marotabap	SF
marAtib	BP
maroyuwl	SF
marAyiyl	BP
maroyuwl	SF
marAyiyl	BP
mas~ap	SF
misAs	BP
maSiyf	SF
maSA}if	BP
maSiyf	SF
maSA}if	BP
masiyl	SF
masAyil	BP
maSiyr	SF
maSA}ir	BP
maSiyr	SF
maSAyir	BP
maSiyr	SF
maSA}ir	BP
maso>alap	SF
masA}il	BP
maso>alap	SF
masA}il	BP
masobak	SF
masAbik	BP
masobak	SF
masAbik	BP
maSodar	SF
maSAdir	BP
maSodar	SF
maSAdir	BP
maSoEad	SF
maSAEid	BP
maSoEad	SF
maSAEid	BP
masoEaY	SF
masAEiy	BP
masoEaY	SF
masAEiy	BP
masojid	SF
masAjid	BP
masokab	SF
masAkib	BP
masokab	SF
masAkib	BP
maSolaHap	SF
maSAliH	BP
maSolaHap	SF
maSAliH	BP
masolax	SF
masAlix	BP
masolax	SF
masAlix	BP
maSonaE	SF
maSAniE	BP
maSonaE	SF
maSAniE	BP
masoqaT	SF
masAqiT	BP
masoqaT	SF
masAqiT	BP
maSoraE	SF
maSAriE	BP
maSoraE	SF
maSAriE	BP
maSoraf	SF
maSArif	BP
maSoraf	SF
maSArif	BP
masoTabap	SF
masATib	BP
maSoTabap	SF
maSATib	BP
masoTabap	SF
masATib	BP
maSoTabap	SF
maSATib	BP
masoTarap	SF
masATir	BP
masoTarap	SF
masATir	BP
masox	SF
musuwx	BP
masoxuwT	SF
masAxiyT	BP
masoxuwT	SF
masAxiyT	BP
maSoyaf	SF
maSAyif	BP
maSoyaf	SF
maSAyif	BP
mAsuwrap	SF
mawAsiyr	BP
maTiy~ap	SF
maTAyA	BP
maTobaE	SF
maTAbiE	BP
maTobaE	SF
maTAbiE	BP
matoban	SF
matAbin	BP
matoban	SF
matAbin	BP
maTobax	SF
maTAbix	BP
maTobax	SF
maTAbix	BP
maToEam	SF
maTAEim	BP
maToEam	SF
maTAEim	BP
maToEan	SF
maTAEin	BP
maToEan	SF
maTAEin	BP
matoHaf	SF
matAHif	BP
matoHaf	SF
matAHif	BP
maToharap	SF
maTAhir	BP
maToharap	SF
maTAhir	BP
matojar	SF
matAjir	BP
matojar	SF
matAjir	BP
matolafap	SF
matAlif	BP
matolafap	SF
matAlif	BP
maTomaE	SF
maTAmiE	BP
maTomaE	SF
maTAmiE	BP
maTomaH	SF
maTAmiH	BP
maTomaH	SF
maTAmiH	BP
maton	SF
mitAn	BP
maton	SF
mutuwn	BP
maToraH	SF
maTAriH	BP
maToraH	SF
maTAriH	BP
matoras	SF
matAris	BP
matoras	SF
matAris	BP
mavolabap	SF
mavAlib	BP
mavolabap	SF
mavAlib	BP
mavowaY	SF
mavAwiy	BP
mavowaY	SF
mavAwiy	BP
mawoEid	SF
mawAEiyd	BP
mawoEiZap	SF
mawAEiZ	BP
mawoEuwd	SF
mawAEiyd	BP
mawoEuwd	SF
mawAEiyd	BP
mawohibap	SF
mawAhib	BP
mawoj	SF
>amowAj	BP
mawokib	SF
mawAkib	BP
mawolaY	SF
mawAliy	BP
mawolaY	SF
mawAliy	BP
mawolaY	SF
mawAliy	BP
mawolaY	SF
mawAliy	BP
mawolid	SF
mawAlid	BP
mawolij	SF
mawAlij	BP
mawomAp	SF
mawAmiy	BP
mawoqid	SF
mawAqid	BP
mawoqiE	SF
mawAqiE	BP
mawoqif	SF
mawAqif	BP
mawoqit	SF
mawAqit	BP
maworid	SF
mawArid	BP
mawosim	SF
mawAsim	BP
mawoTa>	SF
mawATi}	BP
mawoTa>	SF
mawATi}	BP
mawoTa>	SF
mawATi}	BP
mawoTa>	SF
mawATi}	BP
mawo$uwr	SF
mawA$iyr	BP
mawo$uwr	SF
mawA$iyr	BP
maxAfap	SF
maxAwif	BP
maxobar	SF
maxAbir	BP
maxobar	SF
maxAbir	BP
maxobaz	SF
maxAbiz	BP
maxobaz	SF
maxAbiz	BP
maxofar	SF
maxAfir	BP
maxofar	SF
maxAfir	BP
maxonaq	SF
maxAniq	BP
maxonaq	SF
maxAniq	BP
maxozan	SF
maxAzin	BP
maxozan	SF
maxAzin	BP
mayol	SF
>amoyAl	BP
mayol	SF
muyuwl	BP
mayomanap	SF
mayAmin	BP
mayomanap	SF
mayAmin	BP
mayon	SF
muyuwn	BP
mayosarap	SF
mayAsir	BP
mayosarap	SF
mayAsir	BP
mayotam	SF
mayAtim	BP
mayotam	SF
mayAtim	BP
mayotam	SF
mayAtim	BP
maziy~ap	SF
mazAyA	BP
mazobalap	SF
mazAbil	BP
mazobalap	SF
mazAbil	BP
mazoEamap	SF
mazAEim	BP
mazoEamap	SF
mazAEim	BP
mazogal	SF
mazAgil	BP
mazogal	SF
mazAgil	BP
mazolaq	SF
mazAliq	BP
mazolaq	SF
mazAliq	BP
maZolimap	SF
maZAlim	BP
mazomuwr	SF
mazAmiyr	BP
mazomuwr	SF
mazAmiyr	BP
mazoraE	SF
mazAriE	BP
mazoraE	SF
mazAriE	BP
maZoruwf	SF
maZAriyf	BP
maZoruwf	SF
maZAriyf	BP
mibo*al	SF
mabA*il	BP
mibo*al	SF
mabA*il	BP
mibo$arap	SF
mabA$ir	BP
miboDaE	SF
mabADiE	BP
miboDaE	SF
mabADiE	BP
miboxarap	SF
mabAxir	BP
mibozal	SF
mabAzil	BP
mibozal	SF
mabAzil	BP
midofa>	SF
madAfi}	BP
midofa>	SF
madAfi}	BP
midofaE	SF
madAfiE	BP
midofaE	SF
madAfiE	BP
miDogaT	SF
maDAgiT	BP
miDogaT	SF
maDAgiT	BP
midoHaY	SF
madAHiy	BP
midoHaY	SF
madAHiy	BP
miDomAr	SF
maDAmiyr	BP
miDomAr	SF
maDAmiyr	BP
midoraY	SF
madAriy	BP
midoraY	SF
madAriy	BP
miEojan	SF
maEAjin	BP
miEojan	SF
maEAjin	BP
miEolaf	SF
maEAlif	BP
miEolaf	SF
maEAlif	BP
miEolAq	SF
maEAliyq	BP
miEolAq	SF
maEAliyq	BP
miEoSam	SF
maEASim	BP
miEoSam	SF
maEASim	BP
miEoSarap	SF
maEASir	BP
miEoTaf	SF
maEATif	BP
miEoTaf	SF
maEATif	BP
miEowal	SF
maEAwil	BP
miEowal	SF
maEAwil	BP
miEowAn	SF
maEAwiyn	BP
miEowAn	SF
maEAwiyn	BP
miEoyAr	SF
maEAyiyr	BP
miEoyAr	SF
maEAyiyr	BP
miEozaf	SF
maEAzif	BP
miEozaf	SF
maEAzif	BP
miEozaqap	SF
maEAziq	BP
mifoqas	SF
mafAqis	BP
mifoqas	SF
mafAqis	BP
mifora$	SF
mafAri$	BP
mifora$	SF
mafAri$	BP
mifotAH	SF
mafAtiyH	BP
mifotAH	SF
mafAtiyH	BP
migofar	SF
magAfir	BP
migofar	SF
magAfir	BP
migolAp	SF
magAliy	BP
migorafap	SF
magArif	BP
migowAr	SF
magAwiyr	BP
migowAr	SF
magAwiyr	BP
miHobarap	SF
maHAbir	BP
miHobas	SF
maHAbis	BP
miHobas	SF
maHAbis	BP
miHodalap	SF
maHAdil	BP
miHofar	SF
maHAfir	BP
miHofar	SF
maHAfir	BP
mihomAz	SF
mahAmiyz	BP
mihomaz	SF
mahAmiz	BP
mihomAz	SF
mahAmiyz	BP
mihomaz	SF
mahAmiz	BP
mihonap	SF
mihan	BP
miHonap	SF
miHan	BP
miHoqanap	SF
maHAqin	BP
miHorAb	SF
maHArib	BP
miHorAv	SF
maHAriyv	BP
miHorAv	SF
maHAriyv	BP
miHowar	SF
maHAwir	BP
miHowar	SF
maHAwir	BP
mijo*Af	SF
majA*iyf	BP
mijo*Af	SF
majA*iyf	BP
mijodAf	SF
majAdiyf	BP
mijodAf	SF
majAdiyf	BP
mijohar	SF
majAhir	BP
mijohAr	SF
majAhiyr	BP
mijohar	SF
majAhir	BP
mijohAr	SF
majAhiyr	BP
mijomarap	SF
majAmir	BP
mijorafap	SF
majAriyf	BP
miko$aTap	SF
makA$iT	BP
mikobas	SF
makAbis	BP
mikobas	SF
makAbis	BP
mikonasap	SF
makAnis	BP
mikowAp	SF
makAwiy	BP
mil~ap	SF
milal	BP
miloEaqap	SF
malAEiq	BP
miloHaf	SF
malAHif	BP
miloHaf	SF
malAHif	BP
miloT	SF
muluwT	BP
milowaq	SF
malAwiq	BP
milowaq	SF
malAwiq	BP
milowaY	SF
malAwiy	BP
milowaY	SF
malAwiy	BP
mimoHAp	SF
mamAHiy	BP
mimosaH	SF
mamAsiH	BP
mimosaH	SF
mamAsiH	BP
mino$afap	SF
manA$if	BP
mino$Ar	SF
manA$iyr	BP
mino$Ar	SF
manA$iyr	BP
minobar	SF
manAbir	BP
minobar	SF
manAbir	BP
minoDadap	SF
manADid	BP
minofaDap	SF
manAfiD	BP
minofAx	SF
manAfiyx	BP
minofAx	SF
manAfiyx	BP
minohAj	SF
manAhiyj	BP
minohAj	SF
manAhiyj	BP
minoHap	SF
minaH	BP
minoHat	SF
manAHit	BP
minoHat	SF
manAHit	BP
minojal	SF
manAjil	BP
minojal	SF
manAjil	BP
minojar	SF
manAjir	BP
minojar	SF
manAjir	BP
minokA$	SF
manAkiy$	BP
minokA$	SF
manAkiy$	BP
minoqa$	SF
manAqi$	BP
minoqA$	SF
manAqiy$	BP
minoqa$	SF
manAqi$	BP
minoqA$	SF
manAqiy$	BP
minoqAd	SF
manAqiyd	BP
minoqAd	SF
manAqiyd	BP
minoqAr	SF
manAqiyr	BP
minoqAr	SF
manAqiyr	BP
minosaf	SF
manAsif	BP
minosaf	SF
manAsif	BP
minoTaqap	SF
manATiq	BP
minoxAr	SF
manAxiyr	BP
minoxAr	SF
manAxiyr	BP
minoxas	SF
manAxis	BP
minoxas	SF
manAxis	BP
mi}o*anap	SF
ma|*in	BP
mi$obak	SF
ma$Abik	BP
mi$obak	SF
ma$Abik	BP
mi$ofar	SF
ma$Afir	BP
mi$ofar	SF
ma$Afir	BP
mi$oHamap	SF
ma$AHim	BP
mi$ojab	SF
ma$Ajib	BP
mi$ojab	SF
ma$Ajib	BP
mi$okAp	SF
ma$Akiy	BP
mi$oqap	SF
mi$aq	BP
mi$oraT	SF
ma$AriT	BP
mi$oraT	SF
ma$AriT	BP
mi*oraY	SF
ma*Ariy	BP
mi*oraY	SF
ma*Ariy	BP
mi$oT	SF
>amo$AT	BP
mi$oT	SF
mi$AT	BP
mi*owad	SF
ma*Awid	BP
mi*owad	SF
ma*Awid	BP
mi$owAp	SF
ma$Awiy	BP
miqo$aT	SF
maqA$iT	BP
miqo$aT	SF
maqA$iT	BP
miqolAd	SF
maqAliyd	BP
miqolAd	SF
maqAliyd	BP
miqolad	SF
maqAlid	BP
miqolad	SF
maqAlid	BP
miqolAE	SF
maqAliyE	BP
miqolAE	SF
maqAliyE	BP
miqolaY	SF
maqAliy	BP
miqolaY	SF
maqAliy	BP
miqonab	SF
maqAnib	BP
miqonab	SF
maqAnib	BP
miqora>	SF
maqAri}	BP
miqora>	SF
maqAri}	BP
miqorAb	SF
maqAriyb	BP
miqorAb	SF
maqAriyb	BP
miqoraEap	SF
maqAriE	BP
miqoram	SF
maqArim	BP
miqoram	SF
maqArim	BP
miqowad	SF
maqAwid	BP
miqowad	SF
maqAwid	BP
miqowal	SF
maqAwil	BP
miqowal	SF
maqAwil	BP
miqoyAs	SF
maqAyiys	BP
miqoyAs	SF
maqAyiys	BP
miro>ab	SF
marA}ib	BP
miro>ab	SF
marA}ib	BP
mirofaq	SF
marAfiq	BP
mirofaq	SF
marAfiq	BP
miroHAD	SF
marAHiyD	BP
miroHAD	SF
marAHiyD	BP
mirojal	SF
marAjil	BP
mirojal	SF
marAjil	BP
mirokam	SF
marAkim	BP
mirokam	SF
marAkim	BP
mirokan	SF
marAkin	BP
mirokan	SF
marAkin	BP
miroqAp	SF
marAqiy	BP
mirowad	SF
marAwid	BP
mirowad	SF
marAwid	BP
mirowaHap	SF
marAwiH	BP
mirozab~ap	SF
marAzib	BP
miSobAH	SF
maSAbiyH	BP
miSobAH	SF
maSAbiyH	BP
misobar	SF
masAbir	BP
misobar	SF
masAbir	BP
miSoEad	SF
maSAEid	BP
miSoEad	SF
maSAEid	BP
misoEar	SF
masAEir	BP
misoEar	SF
masAEir	BP
miSofAp	SF
maSAfiy	BP
misoHaj	SF
masAHij	BP
misoHaj	SF
masAHij	BP
misoHal	SF
masAHil	BP
misoHal	SF
masAHil	BP
misoHAp	SF
masAHiy	BP
misomaE	SF
masAmiE	BP
misomaE	SF
masAmiE	BP
misomAr	SF
masAmiyr	BP
misomAr	SF
masAmiyr	BP
misonad	SF
masAnid	BP
misonad	SF
masAnid	BP
misoqaY	SF
masAqiy	BP
misoqaY	SF
masAqiy	BP
miSorAE	SF
maSAriyE	BP
miSorAE	SF
maSAriyE	BP
misorajap	SF
masArij	BP
misowAk	SF
masAwiyk	BP
misowAk	SF
masAwiyk	BP
miSoyadap	SF
maSAyid	BP
miToHanap	SF
maTAHin	BP
miTomar	SF
maTAmir	BP
miTomar	SF
maTAmir	BP
miToraq	SF
maTAriq	BP
miToraq	SF
maTAriq	BP
mivoqAl	SF
mavAqiyl	BP
mivoqAl	SF
mavAqiyl	BP
mixobAr	SF
maxAbiyr	BP
mixobAr	SF
maxAbiyr	BP
mixobaT	SF
maxAbiT	BP
mixobaT	SF
maxAbiT	BP
mixodaE	SF
maxAdiE	BP
mixodaE	SF
maxAdiE	BP
mixolab	SF
maxAlib	BP
mixolab	SF
maxAlib	BP
mixolAf	SF
maxAliyf	BP
mixolAf	SF
maxAliyf	BP
mixolap	SF
mixal	BP
mixoraTap	SF
maxAriT	BP
mixoraz	SF
maxAriz	BP
mixoraz	SF
maxAriz	BP
mixoSarap	SF
maxASir	BP
miyEAd	SF
mawAEiyd	BP
miyl	SF
>amoyAl	BP
miynA'	SF
mawAni}	BP
miynA'	SF
mawAniy	BP
miyr	SF
>amoyAr	BP
miys	SF
>amoyAs	BP
miyvAq	SF
mawAviyq	BP
miyzAb	SF
mayAziyb	BP
mizAj	SF
>amozijap	BP
mizofatap	SF
mazAfit	BP
mizolaj	SF
mazAlij	BP
mizolaj	SF
mazAlij	BP
mizomAr	SF
mazAmiyr	BP
mizomAr	SF
mazAmiyr	BP
mizoqap	SF
mizaq	BP
mizorAb	SF
mazAriyb	BP
mizorAb	SF
mazAriyb	BP
mizowad	SF
mazAwid	BP
mizowad	SF
mazAwid	BP
mizowalap	SF
mazAwil	BP
muDogap	SF
muDag	BP
mudoyap	SF
mudaY	BP
muhor	SF
>amohAr	BP
mukoHulap	SF
makAHil	BP
mul~ap	SF
mulal	BP
muloHap	SF
mulaH	BP
munoTAd	SF
manATiyd	BP
munoxal	SF
manAxil	BP
mu&onap	SF
mu&an	BP
muqolap	SF
muqal	BP
murodiy~	SF
marAdiy~	BP
murodiy~	SF
marAdiy~	BP
muTorAn	SF
maTAriyn	BP
muTorAn	SF
maTArinap	BP
muxol	SF
>amoxAl	BP
na$az	SF
>ano$Az	BP
nAb	SF
>anoyAb	BP
naba>	SF
>anobA'	BP
naba>	SF
>anobA}	BP
naba>	SF
>anobA&	BP
nab~Al	SF
nab~Alap	BP
nAbigap	SF
nawAbig	BP
nabiy*	SF
>anobi*ap	BP
nabol	SF
>anobAl	BP
nabol	SF
nibAl	BP
naboz	SF
>anobAz	BP
nab~uwt	SF
nabAbiyt	BP
nadab	SF
>anodAb	BP
nadab	SF
nuduwb	BP
nAdirap	SF
nawAdir	BP
nAdiy	SF
nawAdiy	BP
nAdiy	SF
>anodiyap	BP
nadiym	SF
nidAm	BP
nadiym	SF
nudamA'	BP
naEol	SF
>anoEul	BP
naEol	SF
niEAl	BP
naEot	SF
nuEuwt	BP
nAEuwrap	SF
nawAEiyr	BP
nafa*	SF
>anofA*	BP
nafas	SF
>anofAs	BP
nAfi*ap	SF
nawAfi*	BP
nAfijap	SF
nawAfij	BP
nafiysap	SF
nafA}is	BP
nafonaf	SF
nafAnif	BP
nagom	SF
>anogAm	BP
nAHiy	SF
nuHAap	BP
nAhiyap	SF
nawAhiy	BP
nahod	SF
nuhuwd	BP
nahor	SF
>anohAr	BP
nahor	SF
>anohur	BP
nahor	SF
nuhuwr	BP
naHos	SF
nuHuws	BP
na$iyd	SF
>ano$Ad	BP
na$iyd	SF
na$A}id	BP
najiy~	SF
>anojiyap	BP
najod	SF
nijAd	BP
najom	SF
>anojum	BP
najom	SF
nujuwm	BP
najowaY	SF
najAwaY	BP
nakob	SF
nukuwb	BP
namaT	SF
>anomAT	BP
namaT	SF
nimAT	BP
namir	SF
>anomAr	BP
namiymap	SF
namA}im	BP
nAmuws	SF
nawAmiys	BP
na>oy	SF
|nA'	BP
naqiyb	SF
nuqabA'	BP
naqiyDap	SF
naqA}iD	BP
naqiySap	SF
naqA}iS	BP
naqo$	SF
nuquw$	BP
naqob	SF
>anoqAb	BP
nAquwr	SF
nawAqiyr	BP
nAquws	SF
nawAqiys	BP
narobiy$	SF
narAbiy$	BP
narobiyj	SF
narAbiyj	BP
naS~	SF
nuSuwS	BP
naS~	SF
nuSuwS	BP
nasab	SF
>anosAb	BP
nas~Ax	SF
nas~Axap	BP
nASif	SF
nuS~Af	BP
nASiH	SF
nuS~AH	BP
nAsik	SF
nus~Ak	BP
nASiyap	SF
nawASiy	BP
nasiyb	SF
>anosibA'	BP
naSiyb	SF
>anoSibA'	BP
naSiyb	SF
>anoSibap	BP
naSiyHap	SF
naSA}iH	BP
naSol	SF
>anoSul	BP
naSol	SF
niSAl	BP
naSol	SF
nuSuwl	BP
nasonAs	SF
nasAniys	BP
nasor	SF
nusuwr	BP
nAsuwr	SF
nawAsiyr	BP
nASuwr	SF
nawASiyr	BP
nAti}ap	SF
nawAti}	BP
nATir	SF
naTarap	BP
nATir	SF
nawATir	BP
nATir	SF
nuTarA'	BP
nATir	SF
nuT~Ar	BP
natiyjap	SF
natA}ij	BP
naToE	SF
>anoTAE	BP
naToE	SF
nuTuwE	BP
nATuwr	SF
nawATiyr	BP
nawo'	SF
>anowA'	BP
nawo'	SF
>anowA}	BP
nawo'	SF
>anowA&	BP
nawoE	SF
>anowAE	BP
naworaj	SF
nawArij	BP
naworaj	SF
nawArij	BP
naworaj	SF
nawArij	BP
nawoT	SF
>anowAT	BP
nawoT	SF
niyAT	BP
nayozak	SF
nayAzik	BP
nayozak	SF
nayAzik	BP
nAziEap	SF
nawAziE	BP
nazol	SF
nuzuwl	BP
nibor	SF
>anobAr	BP
nid~	SF
>anodAd	BP
niHolap	SF
niHal	BP
nikol	SF
>anokAl	BP
nikol	SF
nukuwl	BP
nimos	SF
numuws	BP
niqAb	SF
nuqub	BP
nisobap	SF
nisab	BP
niy$An	SF
nayA$iyn	BP
niyr	SF
>anoyAr	BP
nu$~Ab	SF
na$A$iyb	BP
nubo*ap	SF
nuba*	BP
nudofap	SF
nudaf	BP
nukotap	SF
nukat	BP
numoruq	SF
namAriq	BP
nuqorap	SF
nuqar	BP
nuqoTap	SF
nuqaT	BP
nuSob	SF
>anoSAb	BP
nusoxap	SF
nusax	BP
nuTofap	SF
nuTaf	BP
nutofap	SF
nutaf	BP
nuw~Ar	SF
nawAwiyr	BP
nuwbap	SF
nuwab	BP
nuwr	SF
>anowAr	BP
qa*ar	SF
>aqo*Ar	BP
qabaj	SF
qibAj	BP
qabiyHap	SF
qabA}iH	BP
qabiylap	SF
qabA}il	BP
qabor	SF
qubuwr	BP
qabow	SF
>aqobiyap	BP
qadaH	SF
>aqodAH	BP
qADiy	SF
quDAap	BP
qaDiy~ap	SF
qaDAyA	BP
qAduws	SF
qawAdiys	BP
qAE	SF
>aqowAE	BP
qAE	SF
qiyEAn	BP
qAEidap	SF
qawAEid	BP
qaEiydap	SF
qaEA}id	BP
qaEor	SF
quEuwr	BP
qaEuwd	SF
>aqoEidap	BP
qaEuwd	SF
qiEodAn	BP
qaEuwd	SF
quEud	BP
qafaS	SF
>aqofAS	BP
qAfilap	SF
qawAfil	BP
qAfiyap	SF
qawAfiy	BP
qafiyr	SF
quforAn	BP
qa*iyfap	SF
qa*A}if	BP
qalam	SF
>aqolAm	BP
qAlib	SF
qawAlib	BP
qaloEap	SF
qilAE	BP
qaloqalap	SF
qalAqil	BP
qalos	SF
quluws	BP
qamar	SF
>aqomAr	BP
qamiyS	SF
>aqomiSap	BP
qamiyS	SF
qumoSAn	BP
qamiyS	SF
qumuS	BP
qAmuws	SF
qawAmiys	BP
qan~AS	SF
qan~ASap	BP
qanodaq	SF
qanAdiq	BP
qanoTarap	SF
qanATir	BP
qa$oEam	SF
qa$AEim	BP
qArib	SF
qawArib	BP
qAriSap	SF
qawAriS	BP
qariy~ap	SF
qarAyA	BP
qariyb	SF
>aqoribA'	BP
qariyHap	SF
qarA}iH	BP
qaroD	SF
quruwD	BP
qaroEap	SF
qarAEiy	BP
qaroHap	SF
qiraH	BP
qarom	SF
quruwm	BP
qaromaTiy~	SF
qarAmiTap	BP
qaron	SF
quruwn	BP
qaroquwr	SF
qarAqiyr	BP
qaroTal	SF
qarATil	BP
qarow	SF
quruw~	BP
qaroyap	SF
quraY	BP
qaroyap	SF
quraY	BP
qAruwrap	SF
qawAriyr	BP
qaSiydap	SF
qaSA}id	BP
qaSor	SF
quSuwr	BP
qaSoriy~ap	SF
qaSAriy	BP
qasoTal	SF
qasATil	BP
qasoTar	SF
qasATir	BP
qatab	SF
>aqotAb	BP
qATiE	SF
qawATiE	BP
qaTiyE	SF
>aqoTAE	BP
qaTiyE	SF
qiTAE	BP
qaTiyE	SF
quToEAn	BP
qaTiyEap	SF
qaTA}iE	BP
qaTor	SF
qiTAr	BP
qawol	SF
>aqowAl	BP
qawol	SF
>aqAwiyl	BP
qawom	SF
>aqowAm	BP
qawoqaEap	SF
qawAqiE	BP
qawoqaEap	SF
qawAqiE	BP
qawos	SF
>aqowAs	BP
qAwuw$	SF
qawAwiy$	BP
qayol	SF
>aqoyAl	BP
qayon	SF
quyuwn	BP
qid~ap	SF
qidad	BP
qidoH	SF
>aqodAH	BP
qidoH	SF
>aqoduH	BP
qidor	SF
quduwr	BP
qidorap	SF
qidar	BP
qiHof	SF
>aqoHAf	BP
qiHof	SF
qiHafap	BP
qiHof	SF
quHuwf	BP
qilAdap	SF
qalA}id	BP
qiloE	SF
qilAE	BP
qim~ap	SF
qimam	BP
qimoT	SF
>aqomAT	BP
qin~	SF
>aqonAn	BP
qinAE	SF
qunuE	BP
qinodiyl	SF
qanAdiyl	BP
qi$or	SF
qu$uwr	BP
qirAb	SF
>aqoribap	BP
qirAb	SF
qurub	BP
qiro$	SF
quruw$	BP
qirod	SF
quruwd	BP
qiromiyd	SF
qarAmiyd	BP
qiron	SF
>aqorAn	BP
qiroTAs	SF
qarATiys	BP
qisom	SF
>aqosAm	BP
qiToEap	SF
qiTaE	BP
qiyA'	SF
taqiy~	BP
qiyTAn	SF
qayATiyn	BP
qiyvAr	SF
qayAviyr	BP
qu*~ap	SF
qu*a*	BP
qub~ap	SF
qubab	BP
quboDap	SF
qubaD	BP
quboTAn	SF
qabATiyn	BP
quboTAn	SF
qabATinap	BP
quf~ap	SF
qufaf	BP
qufol	SF
>aqofAl	BP
qufol	SF
qufuwl	BP
qufoTAn	SF
qafATiyn	BP
quHomap	SF
quHam	BP
qul~ap	SF
qulal	BP
qumA$	SF
>aqomi$ap	BP
qumobAz	SF
qanAbiyz	BP
qumoE	SF
>aqomAE	BP
qumoqum	SF
qamAqim	BP
qunobulap	SF
qanAbil	BP
qunobur	SF
qanAbir	BP
qunofu*	SF
qanAfi*	BP
qunoSul	SF
qanASil	BP
qunozuEap	SF
qanAziE	BP
qurAd	SF
qirodAn	BP
quroEap	SF
quraE	BP
quromap	SF
quram	BP
quronap	SF
quran	BP
quroS	SF
>aqorAS	BP
quroSAn	SF
qarASinap	BP
quroSap	SF
quraS	BP
quroT	SF
>aqorAT	BP
quroT	SF
quruwT	BP
quwnap	SF
quwan	BP
rab~	SF
>arobAb	BP
rabaD	SF
>arobAD	BP
rAbiTap	SF
rawAbiT	BP
rAbiyap	SF
rawAbiy	BP
raboE	SF
ribAE	BP
rabowap	SF
rubaY	BP
rabowap	SF
rubaY	BP
raD~	SF
ruDuwD	BP
raD~	SF
ruDuwD	BP
raEiy~ap	SF
raEAyA	BP
raEiyl	SF
riEAl	BP
rAfidap	SF
rawAfid	BP
rAfiDap	SF
rawAfiD	BP
rafiyEap	SF
rafA}iE	BP
rafiyq	SF
rifAq	BP
rafiyq	SF
rufaqA'	BP
raforaf	SF
rafArif	BP
ragiybap	SF
ragA}ib	BP
raHaY	SF
>aroHA'	BP
rAhib	SF
ruhobAn	BP
rahiynap	SF
rahA}in	BP
rahoT	SF
>arohAT	BP
rahow	SF
rihA'	BP
rahow	SF
rihA}	BP
rA}iEap	SF
rawA}iE	BP
rA}iEap	SF
rawA}iE	BP
rA}iHap	SF
rawA}iH	BP
rA}iHap	SF
rawA}iH	BP
rA$in	SF
rawA$in	BP
ra*iylap	SF
ra*A}il	BP
rakuwb	SF
rakA}ib	BP
ram~AH	SF
ram~AHap	BP
ramakap	SF
rimAk	BP
ramaq	SF
>aromAq	BP
ramav	SF
>aromAv	BP
ramav	SF
rimAv	BP
ramiy~ap	SF
ramAyA	BP
ramol	SF
rimAl	BP
ramos	SF
>aromAs	BP
ramos	SF
rumuws	BP
ramoz	SF
rumuwz	BP
ra$om	SF
ru$uwm	BP
ra>os	SF
>aro&us	BP
ra>os	SF
ru'uws	BP
ra>os	SF
ru&uws	BP
ra$owap	SF
ru$aY	BP
ra$owap	SF
ru$aY	BP
ra>oy	SF
|rA'	BP
raq~	SF
ruquwq	BP
raq~	SF
ruquwq	BP
raqiyb	SF
ruqabA'	BP
raqiym	SF
raqA}im	BP
raqom	SF
>aroqAm	BP
rasan	SF
>arosAn	BP
raSiyf	SF
>aroSifap	BP
rasom	SF
rusuwm	BP
rasuwl	SF
rusul	BP
ratol	SF
>arotAl	BP
raTol	SF
>aroTAl	BP
rawosam	SF
rawAsim	BP
rawosam	SF
rawAsim	BP
rawosam	SF
rawAsim	BP
rayoE	SF
ruyuwE	BP
ridA'	SF
>arodiyap	BP
rido'	SF
>arodA'	BP
rido'	SF
>arodA}	BP
rifod	SF
>arofAd	BP
rifod	SF
rufuwd	BP
rijol	SF
>arojul	BP
rijos	SF
>arojAs	BP
rikAb	SF
rukub	BP
rim~ap	SF
rimam	BP
ritAj	SF
rutuj	BP
riybap	SF
riyab	BP
riyf	SF
>aroyAf	BP
riyH	SF
>aroyAH	BP
rizomap	SF
rizam	BP
rudon	SF
>arodAn	BP
rujomap	SF
rujam	BP
rukon	SF
>arokAn	BP
rumoH	SF
>aromAH	BP
rumoH	SF
rimAH	BP
rusog	SF
>arosAg	BP
rutobap	SF
rutab	BP
ruwb	SF
>arowAb	BP
ruwH	SF
>arowAH	BP
ruxoSap	SF
ruxaS	BP
ruzo'	SF
>arozA'	BP
sabaq	SF
>asobAq	BP
sab~AT	SF
sabAbiyT	BP
Sabiy~	SF
Siboyap	BP
Sabiy~ap	SF
SabAyA	BP
sabiyb	SF
sabA}ib	BP
sabiykap	SF
sabA}ik	BP
sabiyl	SF
>asobilap	BP
sabiyl	SF
subul	BP
saboE	SF
>asobuE	BP
saboE	SF
sibAE	BP
saboE	SF
subuwE	BP
Sadaf	SF
>aSodAf	BP
sad~ap	SF
suduwd	BP
SadaY	SF
>aSodA'	BP
SadaY	SF
>aSodA}	BP
SadaY	SF
>aSodA&	BP
sAdin	SF
sadanap	BP
SadoE	SF
SuduwE	BP
SAE	SF
>aSowAE	BP
sAEid	SF
sawAEid	BP
SaEiyd	SF
SuEud	BP
saEodAn	SF
saEAdiyn	BP
Safad	SF
>aSofAd	BP
safaT	SF
>asofAT	BP
safiyfap	SF
safA}if	BP
SafiyHap	SF
SafA}iH	BP
safiynap	SF
safA}in	BP
safiynap	SF
sufun	BP
safoH	SF
sufuwH	BP
saf~uwd	SF
safAfiyd	BP
SaH~Arap	SF
SaHAHiyr	BP
sAHil	SF
sawAHil	BP
SaHiyfap	SF
SuHuf	BP
SaHofap	SF
SiHAf	BP
sahom	SF
>asohum	BP
SaHon	SF
SuHuwn	BP
SaHorA'	SF
SaHAraY	BP
SA}ilap	SF
SawA}il	BP
SA}ilap	SF
SawA}il	BP
sA}is	SF
suw~As	BP
saj~Adap	SF
sajAjiyd	BP
sAjid	SF
suj~ad	BP
sajof	SF
>asojAf	BP
sajof	SF
sujuwf	BP
Sak~	SF
Sukuwk	BP
Sak~	SF
Sukuwk	BP
sal~ap	SF
silAl	BP
sAlib	SF
sawAlib	BP
SAliH	SF
SawAliH	BP
Saliyb	SF
SulobAn	BP
saliylap	SF
salA}il	BP
saliyqap	SF
salA}iq	BP
salojuwqiy~	SF
salAjiqap	BP
samar	SF
>asomAr	BP
Samog	SF
Sumuwg	BP
samot	SF
sumuwt	BP
SAmuwlap	SF
SawAmiyl	BP
samuwm	SF
samA}im	BP
sanAm	SF
>asonimap	BP
sAniyap	SF
sawAniy	BP
SaniyEap	SF
SanA}iE	BP
Sanodal	SF
SanAdil	BP
sanodAn	SF
sanAdiyn	BP
Sanoj	SF
Sunuwj	BP
sanojaq	SF
sanAjiq	BP
sAq	SF
siyqAn	BP
sAqiy	SF
suqAap	BP
saqiyfap	SF
saqA}if	BP
Saqolabiy~	SF
SaqAlibap	BP
sarab	SF
>asorAb	BP
sAribap	SF
sawArib	BP
sariy~	SF
>asoriyap	BP
sariy~	SF
suroyAn	BP
sariy~ap	SF
sarAyA	BP
Sariyfap	SF
SarA}if	BP
sariyr	SF
sarA}ir	BP
sariyr	SF
sarAyir	BP
Sarod	SF
Suruwd	BP
SaroH	SF
SuruwH	BP
saroj	SF
suruwj	BP
SAruwx	SF
SawAriyx	BP
satoh	SF
>asotAh	BP
saToH	SF
>asoTuH	BP
saToH	SF
suTuwH	BP
saTol	SF
>asoTAl	BP
saTol	SF
suTuwl	BP
saTor	SF
>asoTAr	BP
saTor	SF
>asoTur	BP
saTor	SF
suTuwr	BP
sATuwr	SF
sawATiyr	BP
SawomaEap	SF
SawAmiE	BP
SawomaEap	SF
SawAmiE	BP
sawoT	SF
>asowAT	BP
Sawot	SF
>aSowAt	BP
sawoT	SF
siyAT	BP
saxiymap	SF
saxA}im	BP
saxolap	SF
sixAl	BP
Sayof	SF
>aSoyAf	BP
Sayof	SF
Suyuwf	BP
sayof	SF
>asoyAf	BP
sayof	SF
suyuwf	BP
sayor	SF
suyuwr	BP
Sayoraf	SF
SayArif	BP
Sayoraf	SF
SayArif	BP
Sayorafiy~	SF
SayArifap	BP
SibAg	SF
>aSobigap	BP
sibAr	SF
subur	BP
Sibog	SF
>aSobAg	BP
sidol	SF
>asodAl	BP
siEolaY	SF
saEAliy	BP
siEor	SF
>asoEAr	BP
sifor	SF
>asofAr	BP
siHoliy~ap	SF
saHAliy	BP
Sihor	SF
>aSohAr	BP
Sihoriyj	SF
SahAriyj	BP
sijon	SF
sujuwn	BP
sik~ap	SF
sikak	BP
sik~iyn	SF
sakAkiyn	BP
silAH	SF
>asoliHap	BP
silok	SF
>asolAk	BP
silosilap	SF
salAsil	BP
simAT	SF
>asomiTap	BP
simAT	SF
sumuT	BP
SimAx	SF
>aSomixap	BP
simosAr	SF
samAsirap	BP
simoT	SF
sumuwT	BP
sin~	SF
>asonAn	BP
Sin~Arap	SF
SanAniyr	BP
Sinof	SF
>aSonAf	BP
Sinof	SF
Sunuwf	BP
Sinow	SF
>aSonA'	BP
sir~	SF
>asorAr	BP
sirAj	SF
suruj	BP
|Sirap	SF
>awASir	BP
SirAT	SF
SuruT	BP
sirob	SF
>asorAb	BP
sirobAl	SF
sarAbiyl	BP
sirodAb	SF
sarAdiyb	BP
sitAr	SF
sutur	BP
Siygap	SF
Siyag	BP
siyjArap	SF
sajA}ir	BP
siyjArap	SF
sajAyir	BP
siykArap	SF
sakA}ir	BP
siykArap	SF
sakAyir	BP
siyrap	SF
siyar	BP
su&Al	SF
>aso}ilap	BP
SubAE	SF
SawAbiE	BP
SuboH	SF
>aSobAH	BP
sud~	SF
>asodAd	BP
sud~ap	SF
sudad	BP
Sudog	SF
>aSodAg	BP
SuEoluwk	SF
SaEAliyk	BP
suforap	SF
sufar	BP
suhob	SF
suhuwb	BP
suHot	SF
>asoHAt	BP
sulaHofAp	SF
salAHif	BP
sul~am	SF
salAlim	BP
suloTAn	SF
salATiyn	BP
suloTap	SF
sulaT	BP
sun~ap	SF
sunan	BP
sunobuk	SF
sanAbik	BP
sunobul	SF
sanAbil	BP
sunobuwq	SF
sanAbiyk	BP
sunobuwq	SF
sanAbiyq	BP
Sunobuwr	SF
SanAbiyr	BP
Sunoduwq	SF
SanAdiyq	BP
SuqoE	SF
>aSoqAE	BP
surobap	SF
surab	BP
suroE	SF
>asorAE	BP
surom	SF
>asorAm	BP
SuroSur	SF
SarASir	BP
SuroSuwr	SF
SarASiyr	BP
sutorap	SF
sutar	BP
suw'	SF
>asowA'	BP
Suw~ap	SF
Suway	BP
Suw~ap	SF
Suway	BP
suwq	SF
>asowAq	BP
suwr	SF
>asowAr	BP
suwrap	SF
suwar	BP
Suwrap	SF
Suwar	BP
SuwS	SF
SiySAn	BP
suws	SF
siysAn	BP
TAbiq	SF
TawAbiq	BP
TAbiyap	SF
TawAbiy	BP
Tabol	SF
Tubuwl	BP
TAbuwr	SF
TawAbiyr	BP
tAbuwt	SF
tawAbiyt	BP
taEoriy$ap	SF
taEAriy$	BP
taEowiy*	SF
taEAwiy*	BP
taEowiy*	SF
taEAwiy*	BP
TAfiyap	SF
TawAfiy	BP
TAguwt	SF
TawAgiyt	BP
TAHin	SF
TawAHin	BP
taHomiylap	SF
taHAmiyl	BP
TAHuwnap	SF
TawAHiyn	BP
TA}ifap	SF
TawA}if	BP
TA}ifap	SF
TawA}if	BP
tAj	SF
tiyjAn	BP
TAjin	SF
TawAjin	BP
tajoribap	SF
tajArib	BP
takiy~ap	SF
takAyA	BP
talam	SF
>atolAm	BP
talobiyb	SF
talAbiyb	BP
talobiyb	SF
talAbiyb	BP
taloEap	SF
tilAE	BP
talofiyHap	SF
talAfiyH	BP
taloHiyn	SF
talAHiyn	BP
taloHiyn	SF
talAHiyn	BP
talotalap	SF
talAtil	BP
TaloyAniy~	SF
TalAyinap	BP
Taluwqap	SF
TalA}iq	BP
tamiymap	SF
tamA}im	BP
tamoriyn	SF
tamAriyn	BP
tamoriyn	SF
tamAriyn	BP
tanobar	SF
tanAbir	BP
Tanojarap	SF
TanAjir	BP
tan~uwr	SF
tanAniyr	BP
ta*okarap	SF
ta*Akir	BP
Ta$ot	SF
Tu$uwt	BP
TAqiyap	SF
TawAqiy	BP
taqoriyr	SF
taqAriyr	BP
taqoriyr	SF
taqAriyr	BP
TaqoTuwqap	SF
TaqATiyq	BP
Tar~AHap	SF
TarAriyH	BP
tariybap	SF
tarA}ib	BP
Tariydap	SF
TarA}id	BP
Tariyfap	SF
TarA}if	BP
tAriyx	SF
tawAriyx	BP
Taro$	SF
Turuw$	BP
Tarobuw$	SF
TarAbiy$	BP
Tarod	SF
Turuwd	BP
TaroHap	SF
TirAH	BP
TaroHap	SF
TuraH	BP
tarotiylap	SF
tarAtiyl	BP
tarowiyHap	SF
tarAwiyH	BP
Taroz	SF
Turuwz	BP
taSomiym	SF
taSAmiym	BP
taSomiym	SF
taSAmiym	BP
Tasot	SF
Tusuwt	BP
taSowiyrap	SF
taSAwiyr	BP
TA&uws	SF
TawAwiys	BP
Tawiy~ap	SF
TawAyA	BP
Tawod	SF
>aTowAd	BP
Tawof	SF
>aTowAf	BP
Tawor	SF
>aTowAr	BP
taxom	SF
tuxuwm	BP
taxot	SF
tuxuwt	BP
Tayor	SF
>aToyAr	BP
Tayor	SF
Tuyuwr	BP
tayos	SF
>atoyAs	BP
tayos	SF
tuyuws	BP
tik~ap	SF
tikak	BP
timosAH	SF
tamAsiyH	BP
timosAH	SF
tamAsiyH	BP
timovAl	SF
tamAviyl	BP
timovAl	SF
tamAviyl	BP
tin~iyn	SF
tanAniyn	BP
tirob	SF
>atorAb	BP
tirobAs	SF
tarAbiys	BP
tirobAs	SF
tarAbiys	BP
Tiros	SF
Turuws	BP
tiros	SF
turuws	BP
TuEom	SF
TuEuwm	BP
tuHofap	SF
tuHaf	BP
tuhomap	SF
tuham	BP
Tun~	SF
>aTonAn	BP
Tunobur	SF
TanAbir	BP
Tunobuwr	SF
TanAbiyr	BP
Tunub	SF
>aTonAb	BP
Tur~ap	SF
Turar	BP
turos	SF
>atorAs	BP
Tuwl	SF
>aTowAl	BP
>u$Abap	SF
>a$A}ib	BP
$ub~Ak	SF
$abAbiyk	BP
>uDoHiy~ap	SF
>aDAHiy~	BP
>uDoHuwkap	SF
>aDAHiyk	BP
>uDoluwlap	SF
>aDAliyl	BP
$uEobap	SF
$uEab	BP
>ufoHuwS	SF
>afAHiyS	BP
>ufoHuwS	SF
>afAHiyS	BP
>ufokuwhap	SF
>afAkiyh	BP
>ufonuwn	SF
>afAniyn	BP
>ufonuwn	SF
>afAniyn	BP
>ugowiy~ap	SF
>agAwiy~	BP
>uHobuwlap	SF
>aHAbiyl	BP
>uHofuwr	SF
>aHAfiyr	BP
>uHofuwr	SF
>aHAfiyr	BP
>uhojuw~ap	SF
>ahAjiy~	BP
>uhozuwjap	SF
>ahAziyj	BP
>ujorap	SF
>ujar	BP
$ukor	SF
$ukuwr	BP
>ukorap	SF
>ukar	BP
>ukosiyd	SF
>akAsiyd	BP
>uko*uwbap	SF
>akA*iyb	BP
>um~ap	SF
>umam	BP
>umoluwHap	SF
>amAliyH	BP
>unobuwb	SF
>anAbiyb	BP
>unobuwb	SF
>anAbiyb	BP
>unomulap	SF
>anAmil	BP
>uno$uwdap	SF
>anA$iyd	BP
>uno$uwTap	SF
>anA$iyT	BP
>uqonuwm	SF
>aqAniym	BP
>uqonuwm	SF
>aqAniym	BP
>uqoSuwSap	SF
>aqASiyS	BP
$uqo*uf	SF
$aqA*if	BP
$ur~Abap	SF
$arAriyb	BP
>urofap	SF
>uraf	BP
>urogun	SF
>arAgin	BP
>urogun	SF
>arAgin	BP
>urojuwzap	SF
>arAjiyz	BP
>uroniyk	SF
>arAniyk	BP
>uroTap	SF
>uraT	BP
$uro$uwr	SF
$arA$iyr	BP
*urowap	SF
*uraY	BP
>uSobuwE	SF
>aSAbiyE	BP
>uSobuwE	SF
>aSAbiyE	BP
>usobuwE	SF
>asAbiyE	BP
>usobuwE	SF
>asAbiyE	BP
>usoquf	SF
>asAqif	BP
>usoquf	SF
>asAqif	BP
>usoTuwl	SF
>asATiyl	BP
>usoTuwl	SF
>asATiyl	BP
>usoTuwrap	SF
>asATiyr	BP
$uTofap	SF
$uTaf	BP
>uTum	SF
|TAm	BP
>u*un	SF
|*An	BP
>uwDap	SF
>uwaD	BP
>uw$iy~ap	SF
>awA$iy	BP
>uxoduwd	SF
>axAdiyd	BP
>uxoduwd	SF
>axAdiyd	BP
vadoy	SF
>avodA'	BP
vadoy	SF
>avodA}	BP
vadoy	SF
>avodA&	BP
vaEolab	SF
vaEAlib	BP
vagor	SF
vuguwr	BP
vaman	SF
>avomAn	BP
vamar	SF
>avomAr	BP
vamar	SF
vimAr	BP
vAniyap	SF
vawAniy	BP
vawob	SF
>avowAb	BP
vawob	SF
viyAb	BP
vawor	SF
viyrAn	BP
vinoy	SF
>avonA'	BP
vinoy	SF
>avonA&	BP
viqal	SF
>avoqAl	BP
vubonap	SF
vuban	BP
vuEobAn	SF
vaEAbiyn	BP
vul~ap	SF
vulal	BP
vulomap	SF
vulam	BP
vun~ap	SF
vunan	BP
vuqob	SF
>avoqAb	BP
vuqob	SF
vuquwb	BP
vuqobap	SF
vuqab	BP
vuw~ap	SF
vuwaY	BP
vuw~ap	SF
vuwaY	BP
wabA'	SF
>awobi}ap	BP
waba>	SF
>awobA'	BP
waba>	SF
>awobA}	BP
wadaj	SF
>awodAj	BP
wAdiy	SF
>awodiyap	BP
wadiyEap	SF
wadA}iE	BP
waDiyEap	SF
waDA}iE	BP
waEod	SF
wuEuwd	BP
wafod	SF
wufuwd	BP
wafoDap	SF
wifAD	BP
wagod	SF
>awogAd	BP
wagod	SF
wugodAn	BP
waHo$	SF
wuHo$An	BP
waHo$	SF
wuHuw$	BP
wahodap	SF
wihAd	BP
wahodap	SF
wuhad	BP
wahom	SF
>awohAm	BP
waHomaY	SF
waHAmaY	BP
wahoq	SF
>awohAq	BP
wA$iy	SF
wu$Aap	BP
wa$iyEap	SF
wa$A}iE	BP
wa$iyjap	SF
wa$A}ij	BP
wajaE	SF
>awojAE	BP
wajaE	SF
wijAE	BP
wajor	SF
>awojAr	BP
wakon	SF
wukuwn	BP
wakor	SF
>awokAr	BP
wakor	SF
wukuwr	BP
wAliy	SF
wulAap	BP
waliydap	SF
walA}id	BP
waliymap	SF
walA}im	BP
wa$om	SF
wi$Am	BP
wa$om	SF
wu$uwm	BP
waqob	SF
>awoqAb	BP
waqor	SF
wuquwr	BP
waral	SF
>aworAl	BP
waral	SF
wirolAn	BP
waram	SF
>aworAm	BP
waraq	SF
>aworAq	BP
wariyd	SF
>aworidap	BP
warob	SF
>aworAb	BP
warok	SF
>aworAk	BP
waSab	SF
>awoSAb	BP
wAsiTap	SF
wasA}iT	BP
waSiy~	SF
>awoSiyA'	BP
waSiy~	SF
>awoSiyA'	BP
waSiyd	SF
wuSud	BP
waSiyf	SF
wuSafA'	BP
wasiylap	SF
wasA}il	BP
wasiyT	SF
wusaTA'	BP
waSof	SF
>awoSAf	BP
wasom	SF
wusuwm	BP
wasowAs	SF
wasAwis	BP
watad	SF
>awotAd	BP
waTan	SF
>awoTAn	BP
watar	SF
>awotAr	BP
watiyn	SF
wutun	BP
waTob	SF
wiTAb	BP
waTowAT	SF
waTAwiT	BP
waTowAT	SF
waTAwiyT	BP
wavan	SF
>awovAn	BP
waviyqap	SF
wavA}iq	BP
waziyEap	SF
wazA}iE	BP
waZiyfap	SF
waZA}if	BP
wiEA'	SF
>awoEiyap	BP
wijAr	SF
>awojirap	BP
wikA'	SF
>awokiyap	BP
wi$ob	SF
>awo$Ab	BP
wiqor	SF
>awoqAr	BP
wisAm	SF
>awosimap	BP
wizor	SF
>awozAr	BP
xabar	SF
>axobAr	BP
xAbi}ap	SF
xawAbiy	BP
xAbuwr	SF
xawAbiyr	BP
xadiyj	SF
xuduj	BP
xafiy~ap	SF
xafAyA	BP
xafiyr	SF
xufarA'	BP
xAl	SF
>axowAl	BP
xAl	SF
xiylAn	BP
xalad	SF
>axolAd	BP
xalaf	SF
>axolAf	BP
xaliy~ap	SF
xalAyA	BP
xaliyfap	SF
xulafA'	BP
xaliyj	SF
xulojAn	BP
xaliyj	SF
xuluj	BP
xalobuwS	SF
xalAbiyS	BP
xaloqiyn	SF
xalAqiyn	BP
xaloxAl	SF
xalAxiyl	BP
xaloxal	SF
xalAxil	BP
xamiyr	SF
xamA}ir	BP
xamo$	SF
xumuw$	BP
xanodaq	SF
xanAdiq	BP
xanojar	SF
xanAjir	BP
xa$oxA$	SF
xa$Axiy$	BP
xariyTap	SF
xarA}iT	BP
xarobuw$	SF
xarAbiy$	BP
xarofuw$ap	SF
xarAfiy$	BP
xarom	SF
xuruwm	BP
xAS~ap	SF
xawAS~	BP
xASirap	SF
xawASir	BP
xaSiy~	SF
xiSoyap	BP
xaSiym	SF
xuSamA'	BP
xaSiym	SF
xuSomAn	BP
xaSiyS	SF
>axiS~A'	BP
xaSofap	SF
xiSAf	BP
xaSom	SF
>axoSAm	BP
xaSom	SF
xuSuwm	BP
xaSor	SF
xuSuwr	BP
xaTa>	SF
>axoTA'	BP
xaTa>	SF
>axoTA}	BP
xaTa>	SF
>axoTA&	BP
xAtam	SF
xawAtim	BP
xATirap	SF
xawATir	BP
xaTiyb	SF
xuTabA'	BP
xatom	SF
>axotAm	BP
xatom	SF
xutuwm	BP
xaton	SF
>axotAn	BP
xawor	SF
>axowAr	BP
xawor	SF
xiyrAn	BP
xayAl	SF
>axoyilap	BP
xayol	SF
xuyuwl	BP
xayoT	SF
>axoyAT	BP
xayoT	SF
xiyTAn	BP
xayoT	SF
xuyuwT	BP
xayo$uwm	SF
xayA$iym	BP
xAzuwq	SF
xawAziyq	BP
xibA'	SF
>axobi}ap	BP
xibA'	SF
>axobiyap	BP
xidon	SF
>axodAn	BP
xiloEap	SF
xilaE	BP
xinoSir	SF
xanASir	BP
xinoziyr	SF
xanAziyr	BP
xiroqap	SF
xiraq	BP
xuDorap	SF
xuDar	BP
xuf~A$	SF
xafAfiy$	BP
xum~	SF
>axomAm	BP
xun~	SF
>axonAn	BP
xunofus	SF
xanAfis	BP
xunovaY	SF
xinAv	BP
xuroTuwm	SF
xarATiym	BP
xuS~	SF
>axoSAS	BP
xuSoyap	SF
xuSaY	BP
xuT~ap	SF
xuTaT	BP
xuTobap	SF
xuTab	BP
xuwAn	SF
>axowinap	BP
yaEofuwr	SF
yaEAfiyr	BP
yaEofuwr	SF
yaEAfiyr	BP
yamiyn	SF
>ayomAn	BP
yamiyn	SF
>ayomun	BP
yAquwt	SF
yawAqiyt	BP
yarobuwE	SF
yarAbiyE	BP
yarobuwE	SF
yarAbiyE	BP
yasoruwE	SF
yasAriyE	BP
yasoruwE	SF
yasAriyE	BP
yawom	SF
>ay~Am	BP
yaxot	SF
yuxuwt	BP
zabodiy~ap	SF
zabAdiy	BP
Zaboy	SF
ZibA'	BP
ZaEiynap	SF
ZaEA}in	BP
zAg	SF
ziygAn	BP
zajal	SF
>azojAl	BP
zAjirap	SF
zawAjir	BP
zakiybap	SF
zakA}ib	BP
zalam	SF
>azolAm	BP
zaloEap	SF
zilaE	BP
zaloEuwm	SF
zalAEiym	BP
zamAn	SF
>azominap	BP
zaman	SF
>azomAn	BP
zam~Arap	SF
zamAmiyr	BP
zamor	SF
zumuwr	BP
zanobiyl	SF
zanAbiyl	BP
zarad	SF
zuruwd	BP
zariybap	SF
zarA}ib	BP
zAruwb	SF
zawAriyb	BP
zawobaEap	SF
zawAbiE	BP
zawobaEap	SF
zawAbiE	BP
zawoj	SF
>azowAj	BP
zawol	SF
>azowAl	BP
zaworaq	SF
zawAriq	BP
zaworaq	SF
zawAriq	BP
zaworaq	SF
zawAriq	BP
zayot	SF
zuyuwt	BP
zinodiyq	SF
zanAdiqap	BP
zinojiyr	SF
zanAjiyr	BP
zir~	SF
>azorAr	BP
ziyH	SF
>azoyAH	BP
zub~	SF
>azobAb	BP
zubodap	SF
zubad	BP
zuborap	SF
zubar	BP
zuboyap	SF
zubaY	BP
Zufur	SF
>aZofAr	BP
zugoluwl	SF
zagAliyl	BP
zukorap	SF
zukar	BP
zumorap	SF
zumar	BP
zun~Ar	SF
zanAniyr	BP
zunobuwr	SF
zanAbiyr	BP
zuqAq	SF
>aziq~ap	BP
zurozur	SF
zarAziyr	BP
zuxoruf	SF
zaxArif	BP